,TradeDate,Open,High,Low,Close,Adj_Close,Volume,Ticker,bollinger_sma,bollinger_band_lower,bollinger_band_upper,bollinger_band_percentage,stochastic_oscillator_sma,rolling_avg,price_to_SMA_ratio,multiplier,on_balance_volume,window_start_price,window_end_price,momentum,tweet_date,pct_positive,pct_negative,pct_neutral,avg_compound_sentiment,tweet_volume,MACD_raw,MACD_signal,MACD
0,2017-03-21,1055.36,1122.43,1055.36,1120.54,1120.54,337391008,BTC,1120.540000,,,,,1120.540000,0E-17,1,337391008,1120.54,1120.54,0E-13,2017-03-21,0.0,0.0,1.0,0.1078378,74,0.0,0.0,0.0
1,2017-03-22,1120.65,1120.65,1014.21,1049.14,1049.14,380840992,BTC,1084.840000,983.8651516465611,1185.8148483534387,0.3232233047033637,0E-19,1084.840000,-0.03290807861067070,-1,-43449984,1120.54,1049.14,-0.0637192782052,2017-03-22,0.0,0.0,1.0,-0.0208462,65,-1.601923076922958,-0.8899572649571988,-0.7119658119657591
2,2017-03-23,1050.05,1058.01,1028.93,1038.59,1038.59,248540000,BTC,1069.423333,980.2603174984292,1158.5863485015707,0.32709572558446687,0E-19,1069.423333,-0.02883173767445749,-1,-291989984,1120.54,1038.59,-0.0731343816374,2017-03-23,0.0,0.0,1.0,0.0658689,61,-2.3683228293666616,-1.4958447913545194,-0.8724780380121422
3,2017-03-24,1038.45,1040.47,934.36,937.52,937.52,491038016,BTC,1036.447500,885.7872257624513,1187.1077742375487,0.17168684478823107,0E-19,1036.447500,-0.09544863584503798,-1,-783028000,1120.54,937.52,-0.1633319649455,2017-03-24,0.0,0.0,1.0,0.0646456,79,-6.307948735743139,-3.125961303681287,-3.181987432061852
4,2017-03-25,936.54,975.76,903.71,972.78,972.78,435803008,BTC,1023.714000,881.3527372913544,1166.0752627086458,0.32111004415491573,4.8164135067205000000,1023.714000,-0.04975413054818045,1,-347224992,1120.54,972.78,-0.1318649936638,2017-03-25,0.0,0.0,1.0,0.211,38,-6.912807778449746,-4.2524625158327805,-2.660345262616966
5,2017-03-26,974.02,1007.96,954.19,966.72,966.72,303668000,BTC,1014.215000,878.6460975186418,1149.7839024813582,0.32483077191492754,8.8050486285650000000,1014.215000,-0.04682932119915403,-1,-650892992,1120.54,966.72,-0.1372731004694,2017-03-26,0.0,0.0,1.0,0.0798485,66,-7.405601435414951,-5.107138474172124,-2.2984629612428273
6,2017-03-27,972.05,1046.40,971.98,1045.77,1045.77,372535008,BTC,1018.722857,892.6881217273851,1144.7575922726148,0.6073003523254786,23.5916839689650000000,1018.722857,0.02655005020663829,1,-278357984,1120.54,1045.77,-0.0667267567423,2017-03-27,0.0,0.0,1.0,0.0974267,75,-4.012977691997662,-4.830235569757296,0.8172578777596335
7,2017-03-28,1044.58,1064.65,1027.73,1047.15,1047.15,326332000,BTC,1022.276250,903.8720478846551,1140.680452115345,0.6050374461193911,38.5668232980000000000,1022.276250,0.02433173029305924,1,47974016,1120.54,1047.15,-0.0654952076677,2017-03-28,0.0,0.0,1.0,0.1827778,45,-1.6079634365624997,-4.055862981309691,2.447899544747191
8,2017-03-29,1046.08,1055.13,1015.88,1039.97,1039.97,298457984,BTC,1024.242222,912.8588642764255,1135.6255797235747,0.5706020105760877,47.7447819910390000000,1024.242222,0.01535552593144320,-1,-250483968,1120.54,1039.97,-0.0719028325629,2017-03-29,0.035714287,0.0,0.96428573,0.2650714,28,-0.2742963736806132,-3.1823023344986927,2.9080059608180795
9,2017-03-30,1042.21,1049.29,1020.04,1026.43,1026.43,352968992,BTC,1024.461000,919.4386479029345,1129.4833520970656,0.5093741949246205,55.9009944268385000000,1024.461000,0.00192198629328008,-1,-603452960,1120.54,1026.43,-0.0839862923233,2017-03-30,0.0,0.0,1.0,0.131878,41,-0.02167455876792701,-2.4741382385444144,2.4524636797764874
10,2017-03-31,1026.64,1074.92,1026.64,1071.79,1071.79,447287008,BTC,1028.763636,925.123475339095,1132.4037966609048,0.7075757299372386,59.4552507922630000000,1028.763636,0.04182337175844734,1,-156165952,1120.54,1071.79,-0.0435058096989,2017-03-31,0.0,0.0,1.0,0.0218148,54,2.5777578644997448,-1.3688122374097456,3.94657010190949
11,2017-04-01,1071.71,1091.72,1061.09,1080.50,1080.50,289633984,BTC,1033.075000,929.8421576219343,1136.3078423780657,0.7296991873299254,64.0107638509452500000,1033.075000,0.04590663794981003,1,133468032,1120.54,1080.50,-0.0357327716994,2017-04-01,0.0,0.0,1.0,0.0726418,67,4.926910253201186,-0.01675507883300284,4.943665332034189
12,2017-04-02,1080.61,1107.59,1075.45,1102.17,1102.17,514187008,BTC,1038.390000,932.3810642131209,1144.3989357868793,0.8008236972033356,72.5071030488472500000,1038.390000,0.06142200907173605,1,647655040,1120.54,1102.17,-0.0163938815214,2017-04-02,0.023809524,0.0,0.97619045,0.074619,42,7.827846446567037,1.6434351492519812,6.184411297315055
13,2017-04-03,1102.95,1151.74,1102.95,1143.81,1143.81,580444032,BTC,1045.920000,929.5211535875297,1162.3188464124703,0.9204938580452829,85.3622554912032500000,1045.920000,0.09359224414869206,1,1228099072,1120.54,1143.81,0.0207667731629,2017-04-03,0.0,0.0,1.0,0.0637887,71,12.310863409966487,3.8750691005296622,8.435794309436824
14,2017-04-04,1145.52,1156.44,1120.52,1133.25,1133.25,436310016,BTC,1051.742000,930.8508555293292,1172.6331444706707,0.8371131953332389,90.7416119796682500000,1051.742000,0.07749809363893426,-1,791789056,1120.54,1133.25,0.0113427454620,2017-04-04,0.0,0.0,1.0,0.0109063,32,14.908009307046768,6.162125795579988,8.74588351146678
15,2017-04-05,1134.14,1135.09,1113.63,1124.78,1124.78,414784000,BTC,1056.306875,933.9385992160643,1178.6751507839356,0.7797829934324739,93.9047401920770000000,1052.024667,0.06915744020287311,-1,377005056,1049.14,1124.78,0.0720971462341,2017-04-05,0.0,0.0,1.0,0.0264921,63,16.17762741941192,8.22324136606644,7.95438605334548
16,2017-04-06,1125.81,1188.37,1125.81,1182.68,1182.68,511222016,BTC,1063.740588,930.3396640019653,1197.1415119980345,0.9457968072310822,96.4140287944155000000,1060.927333,0.11476060915097566,1,888227072,1038.59,1182.68,0.1387361711551,2017-04-06,0.0,0.0,1.0,0.2459143,35,20.528240707838222,10.740934647030715,9.787306060807508
17,2017-04-07,1178.94,1186.58,1163.39,1176.90,1176.90,317022016,BTC,1070.027222,930.0466462373261,1210.0077977626738,0.8817414574047566,95.8246177975155000000,1070.148000,0.09975442649054150,-1,571205056,937.52,1176.90,0.2553332195580,2017-04-07,0.0,0.0,1.0,0.0700313,64,23.24366980482364,13.287353889597105,9.956315915226535
18,2017-04-08,1172.65,1184.98,1162.58,1175.95,1175.95,209312000,BTC,1075.602105,931.144487597071,1220.0597224029289,0.8473264228085127,96.3252901440670000000,1086.043333,0.08278368299692882,1,780517056,972.78,1175.95,0.2088550340262,2017-04-08,0.0,0.0,1.0,0.2572857,28,24.986843783967288,15.661466436086195,9.325377347881092
19,2017-04-09,1176.57,1197.21,1171.86,1187.87,1187.87,242343008,BTC,1081.215500,931.9154554447135,1230.5155445552864,0.8571817420339259,98.6315095439410000000,1100.382667,0.07950628051832081,1,1022860064,966.72,1187.87,0.2287632406488,2017-04-09,0.0,0.0,1.0,0.3670103,97,26.80586515537334,17.91634313834635,8.88952201702699
20,2017-04-10,1187.30,1190.34,1179.04,1187.13,1187.13,215883008,BTC,1086.259048,933.5740211106861,1238.9440748893137,0.8303236540447569,98.5169158868547500000,1115.076667,0.06461738025050075,-1,806977056,1045.77,1187.13,0.1351731260220,2017-04-10,0.0,0.0,1.0,0.3602079,202,27.84105298684449,19.919763398451096,7.9212895883933925
21,2017-04-11,1187.46,1208.07,1187.46,1205.01,1205.01,216182000,BTC,1090.281429,929.5640238086871,1250.9988341913127,0.8569264040302011,99.1063268837547500000,1125.692667,0.07046091293406285,1,1023159056,1047.15,1205.01,0.1507520412548,2017-04-11,0.0,0.0,1.0,0.2297769,130,29.510093958200514,21.852087546007954,7.6580064121925595
22,2017-04-12,1204.81,1207.14,1196.76,1200.37,1200.37,288702016,BTC,1097.482857,931.0567616732327,1263.9089523267673,0.8091076035822007,99.2358375222172500000,1135.907333,0.05674993472376853,-1,734457040,1039.97,1200.37,0.1542352183236,2017-04-12,0.0,0.0,1.0,0.0072571,70,30.13943522656632,23.519399152679433,6.620036073886887
23,2017-04-13,1201.02,1205.89,1156.44,1169.28,1169.28,351968992,BTC,1103.706190,936.7562815272864,1270.6560984727137,0.6963876787950362,94.2338776162927500000,1144.528000,0.02162638222918094,-1,382488048,1026.43,1169.28,0.1391716921758,2017-04-13,0.01369863,0.0,0.98630136,0.0510137,73,28.135147104338557,24.446928878299392,3.688218226039165
24,2017-04-14,1170.33,1190.80,1159.79,1167.54,1167.54,254827008,BTC,1114.659524,964.1279463857079,1265.191101614292,0.6756457908635489,87.3168694117967500000,1153.935333,0.01178980018284959,-1,127661040,1071.79,1167.54,0.0893365304771,2017-04-14,0.0,0.0,1.0,0.0716087,69,26.124780382446943,24.783771735463837,1.3410086469831057
25,2017-04-15,1167.30,1188.00,1164.96,1172.52,1172.52,203559008,BTC,1124.170952,986.6086010598154,1261.7333029401843,0.6757350309497963,80.7932970079737500000,1160.650667,0.01022644740357522,1,331220048,1080.50,1172.52,0.0851642757982,2017-04-15,0.0,0.0,1.0,0.0546667,51,24.603328081172094,24.74757360246147,-0.14424552128937407
26,2017-04-16,1172.61,1187.22,1172.61,1182.94,1182.94,183231008,BTC,1134.467143,1015.2582857547674,1253.6760002452327,0.703310635300711,76.0777355291760000000,1167.480000,0.01324219686846884,1,514451056,1102.17,1182.94,0.0732827059347,2017-04-16,0.0,0.0,1.0,0.0516721,61,23.86899909418753,24.571432818523498,-0.7024337243359682
27,2017-04-17,1183.25,1194.90,1172.65,1193.91,1193.91,253206000,BTC,1141.521429,1026.9133957238432,1256.1294622761566,0.7285554053343102,77.6208895021577500000,1173.596000,0.01730919328286736,1,767657056,1143.81,1193.91,0.0438009809321,2017-04-17,0.051813472,0.005181347,0.9430052,0.2226468,1158,23.802623372551125,24.417372934173887,-0.6147495616227623
28,2017-04-18,1193.77,1217.57,1193.77,1211.67,1211.67,270524000,BTC,1149.355714,1039.4457824066396,1259.2656455933604,0.7834788680905903,84.6524913637400000000,1178.120000,0.02847757444063423,1,1038181056,1133.25,1211.67,0.0691992058240,2017-04-18,0.0,0.0,1.0,0.0677941,68,24.754283639704227,24.484859505691198,0.269424134013029
29,2017-04-19,1212.13,1215.51,1205.08,1210.29,1210.29,288060992,BTC,1157.466190,1056.701769994486,1258.230610005514,0.7621153875401121,90.7790100214472500000,1183.256000,0.02284712691082910,-1,750120064,1124.78,1210.29,0.0760237557567,2017-04-19,0.0,0.0,1.0,0.115375,80,25.109672064455935,24.60997690528271,0.4996951591732248
30,2017-04-20,1211.08,1240.79,1208.41,1229.08,1229.08,315108000,BTC,1167.116190,1081.3609292922881,1252.8714507077118,0.8612828501052394,96.1441403209415000000,1190.209333,0.03265868105909064,1,1065228064,1182.68,1229.08,0.0392329286028,2017-04-20,0.0,0.0,1.0,0.1679298,57,26.470566685564563,24.982463754446833,1.48810293111773
31,2017-04-21,1229.42,1235.94,1215.56,1222.05,1222.05,272167008,BTC,1174.271429,1097.2969936891216,1251.2458643108782,0.8103535011789025,96.7470801505367500000,1192.834000,0.02449293028200068,-1,793061056,1176.90,1222.05,0.0383634973235,2017-04-21,0.0,0.0,0.93333334,0.1645556,45,26.71019834466688,25.32828466003993,1.381913684626948
32,2017-04-22,1222.71,1235.56,1208.47,1231.71,1231.71,249320000,BTC,1181.471905,1113.5857604286525,1249.3580495713477,0.8700172937881326,96.7470801505367500000,1196.488000,0.02943782135717199,1,1042381056,1175.95,1231.71,0.0474169820145,2017-04-22,0.0,0.0,1.0,0.0534444,63,27.304271083620506,25.723732589658717,1.5805384939617895
33,2017-04-23,1231.92,1232.20,1203.94,1207.21,1207.21,258951008,BTC,1186.473810,1128.351696316415,1244.595923683585,0.6783846860154404,87.5991751932085000000,1198.572000,0.00720690955570462,-1,783430048,1187.87,1207.21,0.0162812428970,2017-04-23,0.0,0.0,1.0,0.1366061,33,25.629389366788928,25.704854372691532,-0.07546500590260408
34,2017-04-24,1209.63,1250.94,1209.63,1250.15,1250.15,235806000,BTC,1191.537619,1130.5673449626424,1252.5078930373575,0.9806635850454547,87.5991751932085000000,1202.724000,0.03943215567328830,1,1019236048,1187.13,1250.15,0.0530860141686,2017-04-24,0.0,0.0,1.0,0.0764464,56,27.237983505826605,26.01160463200666,1.2263788738199466
35,2017-04-25,1250.45,1267.58,1249.97,1265.49,1265.49,242556000,BTC,1197.834762,1134.8654908849403,1260.8040331150596,1.0372083621261714,90.4550412965560000000,1207.948000,0.04763615652329405,1,1261792048,1205.01,1265.49,0.0501904548510,2017-04-25,0.0,0.0,1.0,0.1084321,81,29.336213302323586,26.676742215556644,2.659471086766942
36,2017-04-26,1265.99,1294.83,1265.93,1281.08,1281.08,329631008,BTC,1205.277619,1141.6299978646389,1268.925240135361,1.0954847930513305,90.4550412965560000000,1213.019333,0.05610847671460814,1,1591423056,1200.37,1281.08,0.0672376017395,2017-04-26,0.0125,0.0,0.9875,0.1651375,80,31.81786030047988,27.70523284397424,4.112627456505638
37,2017-04-27,1281.88,1319.70,1281.30,1317.73,1317.73,449196992,BTC,1211.708571,1132.3089691658058,1291.108172834194,1.1676445885799211,100.0000000000000000000,1220.843333,0.07936044239347130,1,2040620048,1169.28,1317.73,0.1269584701697,2017-04-27,0.010752688,0.0,0.9892473,0.1716559,93,36.17351529201369,29.399241165345547,6.774274126668143
38,2017-04-28,1317.74,1331.28,1292.37,1316.48,1316.48,527488992,BTC,1218.355238,1128.511865708206,1308.1986102917942,1.0460879277845305,99.7919302217192500000,1230.656667,0.06973783614987721,-1,1513131056,1167.54,1316.48,0.1275673638591,2017-04-28,0.0,0.0,1.0,0.1410147,68,39.07164326506313,31.334043059394546,7.737600205668585
39,2017-04-29,1317.84,1327.20,1315.21,1321.79,1321.79,422705984,BTC,1225.300000,1127.0687632165814,1323.5312367834185,0.9911370515101134,99.7919302217192500000,1240.940000,0.06515222331458411,1,1935837040,1172.52,1321.79,0.1273069968956,2017-04-29,0.0,0.0,1.0,0.0621045,67,41.297171930370496,33.32693373419748,7.970238196173014
40,2017-04-30,1321.87,1347.91,1314.92,1347.89,1347.89,413115008,BTC,1232.920000,1122.7793352117392,1343.060664788261,1.0219234885726505,99.7919302217192500000,1252.631333,0.07604684993138360,1,2348952048,1182.94,1347.89,0.1394407155054,2017-04-30,0.0,0.0,1.0,0.2367465,71,44.565781885767365,35.574942413797196,8.990839471970169
41,2017-05-01,1348.30,1434.32,1348.30,1421.60,1421.60,713624000,BTC,1244.085238,1108.7779321190465,1379.3925438809533,1.1559688733887796,99.7919302217192500000,1268.542000,0.12065662784519551,1,3062576048,1193.91,1421.60,0.1907095174678,2017-05-01,0.00990099,0.0,0.990099,0.1802475,101,52.279541786565005,38.916146526561725,13.36339526000328
42,2017-05-02,1421.03,1473.90,1415.69,1452.82,1452.82,477337984,BTC,1255.885714,1094.2321426108806,1417.5392853891194,1.1091244514665117,100.0000000000000000000,1285.802667,0.12989344110607604,1,3539914032,1211.67,1452.82,0.1990228362508,2017-05-02,0.0,0.0,0.98550725,0.132058,69,60.12618767076515,43.15844347117151,16.96774419959364
43,2017-05-03,1453.78,1492.77,1447.49,1490.09,1490.09,583795968,BTC,1269.681905,1080.7734582201858,1458.590351779814,1.0833727891926954,100.0000000000000000000,1304.364000,0.14238816772005360,1,4123710000,1210.29,1490.09,0.2311842616232,2017-05-03,0.0,0.0,1.0,0.1552676,71,68.46139196020863,48.2193087086912,20.24208325151743
44,2017-05-04,1490.72,1608.91,1490.72,1537.67,1537.67,933548992,BTC,1287.224286,1071.0268552501013,1503.4217167498985,1.0792060366566536,100.0000000000000000000,1326.189333,0.15946491329530246,1,5057258992,1229.08,1537.67,0.2510739740294,2017-05-04,0.0,0.0,1.0,0.235172,93,77.88982734621732,54.15367091412505,23.736156432092265
45,2017-05-05,1540.87,1618.03,1530.31,1555.45,1555.45,946035968,BTC,1305.696190,1067.3007561950556,1544.0916238049442,1.0238225540098835,100.0000000000000000000,1347.947333,0.15393974372736119,1,6003294960,1222.05,1555.45,0.2728202610368,2017-05-05,0.0,0.0,1.0,0.1444386,57,85.76180354102326,60.475517723715456,25.2862858173078
46,2017-05-06,1556.81,1578.80,1542.50,1578.80,1578.80,582529984,BTC,1325.042857,1066.9143837047932,1583.1713302952066,0.9915326460513958,100.0000000000000000000,1371.730667,0.15095480328719661,1,6585824944,1231.71,1578.80,0.2817952277728,2017-05-06,0.0,0.0,1.0,0.0522941,68,92.76155365193108,66.93290491504159,25.82864873688949
47,2017-05-07,1579.47,1596.72,1559.76,1596.71,1596.71,1080029952,BTC,1344.746190,1069.5703517091943,1619.9220282908059,0.9578232804976952,100.0000000000000000000,1396.064000,0.14372263735759965,1,7665854896,1207.21,1596.71,0.3226447759710,2017-05-07,0.0,0.0,1.0,0.0929863,73,98.57817366590575,73.2620998109771,25.316073854928646
48,2017-05-08,1596.92,1723.35,1596.92,1723.35,1723.35,1340320000,BTC,1369.957619,1058.2365708236048,1681.6786671763953,1.0668407428169944,100.0000000000000000000,1430.473333,0.20474108831219995,1,9006174896,1250.15,1723.35,0.3785145782506,2017-05-08,0.0,0.0,1.0,0.2508804,92,111.89305522630275,80.98842873635638,30.904626489946367
49,2017-05-09,1723.89,1833.49,1716.30,1755.36,1755.36,1167920000,BTC,1395.847619,1050.8102441604171,1740.8849938395826,1.0209759974077404,100.0000000000000000000,1464.154000,0.19889028066719758,1,10174094896,1265.49,1755.36,0.3870990683451,2017-05-09,0.0,0.0,1.0,0.1870159,63,123.5452739709317,89.4999192633236,34.0453547076081
50,2017-05-10,1756.52,1788.44,1719.10,1787.13,1787.13,915723008,BTC,1423.316190,1049.6641456873165,1796.9682343126835,0.9868350321342676,100.0000000000000000000,1498.930000,0.19227048628021322,1,11089817904,1281.08,1787.13,0.3950182658382,2017-05-10,0.018181818,0.0,0.9818182,0.1581091,55,133.7476082683013,98.34955810933214,35.398050158969156
51,2017-05-11,1780.37,1873.93,1755.35,1848.57,1848.57,799489984,BTC,1452.815714,1047.1267454750264,1858.5046825249738,0.9877557891688614,100.0000000000000000000,1536.762667,0.20289882081056567,1,11889307888,1317.73,1848.57,0.4028442852481,2017-05-11,0.0,0.0,1.0,0.2000783,115,145.02839756958588,107.68541127866222,37.34298629092366
52,2017-05-12,1845.76,1856.15,1694.01,1724.24,1724.24,740984000,BTC,1476.729524,1068.9730408154314,1884.4860071845687,0.8035028089154449,94.1584130504237500000,1563.863333,0.10255158722363881,-1,11148323888,1316.48,1724.24,0.3097350510452,2017-05-12,0.0,0.0,1.0,0.109241,83,142.44526571025222,114.6374329669356,27.80783274331661
53,2017-05-13,1723.12,1812.99,1651.08,1804.91,1804.91,579635008,BTC,1504.024762,1088.4892098931293,1919.5603141068707,0.8620451204168158,92.0863905742477500000,1596.425333,0.13059468719919142,1,11727958896,1321.79,1804.91,0.3655043539443,2017-05-13,0.0,0.0,1.0,0.2888021,96,145.1363647940168,120.73725499195135,24.399109802065453
54,2017-05-14,1800.86,1831.42,1776.62,1808.91,1808.91,437196000,BTC,1532.677143,1120.1326379514971,1945.2216480485026,0.8347915844467781,90.1060837914722500000,1628.900000,0.11051016023083062,1,12165154896,1347.89,1808.91,0.3420308778906,2017-05-14,0.0,0.0,1.0,0.1970882,102,145.90156862750086,125.7701412568901,20.131427370610766
55,2017-05-15,1808.44,1812.80,1708.54,1738.43,1738.43,731529024,BTC,1555.928571,1155.3978512150766,1956.4592907849233,0.7278245088142048,83.6571529532400000000,1654.936000,0.05045149782227228,-1,11433625872,1421.60,1738.43,0.2228685987620,2017-05-15,0.013333334,0.0,0.9866667,0.1439867,75,139.28276948443977,128.47267701378672,10.810092470653046
56,2017-05-16,1741.70,1785.94,1686.54,1734.45,1734.45,959044992,BTC,1578.260000,1193.7688876449806,1962.7511123550194,0.7031126272897853,82.2896432508895000000,1675.792667,0.03500273879644563,-1,10474580880,1452.82,1734.45,0.1938505802508,2017-05-16,0.013157895,0.0,0.9868421,0.1675658,76,132.19395192356342,129.2169342234195,2.9770177001439038
57,2017-05-17,1726.73,1864.05,1661.91,1839.09,1839.09,1064729984,BTC,1604.831905,1229.5837137122046,1980.0800962877954,0.8121375404849539,83.7005409781255000000,1701.544000,0.08083599366222678,1,11539310864,1490.09,1839.09,0.2342140407626,2017-05-17,0.015873017,0.0,0.984127,0.2020952,63,133.38985516164757,130.05152040950202,3.338334752145556
58,2017-05-18,1818.70,1904.48,1807.12,1888.65,1888.65,894321024,BTC,1632.018571,1261.4352953230898,2002.6018466769103,0.8462533873543471,85.6808477609010000000,1728.114667,0.09289622735433910,1,12433631888,1537.67,1888.65,0.2282544369078,2017-05-18,0.0,0.011111111,0.98888886,0.1816111,90,136.71847627185366,131.3849141362473,5.333562135606371
59,2017-05-19,1897.37,2004.52,1890.25,1987.71,1987.71,1157289984,BTC,1663.981905,1291.9182343403106,2036.0455756596896,0.9350439461423526,92.1297785991332500000,1758.117333,0.13059007080501834,1,13590921872,1555.45,1987.71,0.2779002860908,2017-05-19,0.0,0.0,1.0,0.1322031,64,145.59539389149472,134.2270144428028,11.368379448691911
60,2017-05-20,1984.24,2084.73,1974.92,2084.73,2084.73,961336000,BTC,1700.312381,1319.6885347735838,2080.936227226416,1.0049836246614554,99.3388752510600000000,1793.402667,0.16244390529837436,1,14552257872,1578.80,2084.73,0.3204522422093,2017-05-20,0.022900764,0.0,0.97709924,0.2198626,131,158.56165536542585,139.09394859417134,19.467706771254512
61,2017-05-21,2067.03,2119.08,2037.50,2041.20,2041.20,1147859968,BTC,1733.327143,1360.9064316456042,2105.7478543543957,0.9133401387376494,97.7700708987337500000,1824.229333,0.11893826235278500,-1,13404397904,1596.71,2041.20,0.2783786661322,2017-05-21,0.024096385,0.0,0.97590363,0.1834458,83,163.46486769850776,143.96813719562888,19.496730502878876
62,2017-05-22,2043.19,2303.90,2017.87,2173.40,2173.40,1942220032,BTC,1769.127143,1378.4708236530398,2159.78346234696,1.0174277708803001,97.7700708987337500000,1862.675333,0.16681633212995364,1,15346617936,1723.35,2173.40,0.2611483447936,2017-05-22,0.029126214,0.0,0.9708738,0.2158835,103,175.91003334860852,150.35652143879202,25.553511909816507
63,2017-05-23,2191.56,2320.82,2178.50,2320.42,2320.42,1378749952,BTC,1810.441429,1378.9113302450828,2241.971527754917,1.0908957132670796,97.7700708987337500000,1902.480000,0.21968167865102393,1,16725367888,1755.36,2320.42,0.3219054780786,2017-05-23,0.0,0.0,1.0,0.2002344,128,195.30173198128955,159.34556918980826,35.95616279148129
64,2017-05-24,2321.37,2523.72,2321.37,2443.64,2443.64,1725379968,BTC,1855.848571,1368.794458470983,2342.902683529017,1.1034149121007384,97.7700708987337500000,1948.365333,0.25420010231725879,1,18450747856,1787.13,2443.64,0.3673543614622,2017-05-24,0.018867925,0.009433962,0.9716981,0.1491038,106,218.03356752396348,171.08317475089083,46.95039277307265
65,2017-05-25,2446.24,2763.71,2285.30,2304.98,2304.98,2406700032,BTC,1892.387143,1390.6793459251344,2394.0949400748655,0.9111884042918635,95.1814011676397500000,1982.888667,0.16243540969312525,-1,16044047824,1848.57,2304.98,0.2468989543269,2017-05-25,0.008474576,0.0,0.9915254,0.1304237,118,222.35774859279604,181.3380936390267,41.01965495376933
66,2017-05-26,2320.89,2573.79,2071.99,2202.42,2202.42,1763480064,BTC,1923.195238,1428.9856895038567,2417.404786496143,0.7824963245344695,86.7987211565192500000,2006.478667,0.09765433155238226,-1,14280567760,1724.24,2202.42,0.2773279821835,2017-05-26,0.01754386,0.0,0.98245615,0.1511842,114,215.07160719473404,188.08479851847554,26.986808676258505
67,2017-05-27,2196.27,2260.20,1855.83,2038.87,2038.87,1700480000,BTC,1945.103333,1474.803704621098,2415.402961378902,0.5996882214464092,72.5299779424300000000,2027.454000,0.00563070728115163,-1,12580087760,1804.91,2038.87,0.1296241917880,2017-05-27,0.011494253,0.0,0.9885057,0.1430115,87,193.92853322499514,189.25354576027615,4.674987464718981
68,2017-05-28,2054.08,2267.34,2054.08,2155.80,2155.80,1147139968,BTC,1971.726667,1521.3847894299329,2422.068544570067,0.7043706594567823,62.3831907626897500000,2050.846667,0.05117561185279972,1,13727227728,1808.91,2155.80,0.1917674179478,2017-05-28,0.0,0.0,1.0,0.1429268,82,184.43775605204496,188.2903876205198,-3.852631568474834
69,2017-05-29,2159.43,2307.05,2107.17,2255.61,2255.61,994625024,BTC,1997.072381,1545.5311753540582,2448.6135866459417,0.7862835282442886,60.5734530420810000000,2080.626667,0.08410126418897812,1,14721852752,1738.43,2255.61,0.2974983174474,2017-05-29,0.009090909,0.0,0.9909091,0.1805636,110,182.82729892080556,187.19776970078618,-4.3704707799806215
70,2017-05-30,2255.36,2301.96,2124.57,2175.47,2175.47,1443970048,BTC,2017.077619,1573.3561440225196,2460.79909397748,0.6784817615690549,59.5027425654620000000,2109.762667,0.03114441924097238,-1,13277882704,1734.45,2175.47,0.2542708063075,2017-05-30,0.0,0.011904762,0.9880952,0.1242976,84,173.1130174644195,184.3808188826884,-11.267801418268903
71,2017-05-31,2187.19,2311.08,2145.57,2286.41,2286.41,1544829952,BTC,2040.852857,1595.3784447542298,2486.3272692457704,0.7756130725467176,67.2695421851422500000,2146.560000,0.06515075283243888,1,14822712656,1839.09,2286.41,0.2432289882496,2017-05-31,0.0,0.0,1.0,0.2037692,91,172.3461892819455,181.9738927090609,-9.627703427115392
72,2017-06-01,2288.33,2448.39,2288.33,2407.88,2407.88,1653180032,BTC,2067.486667,1603.7891513140378,2531.1841826859627,0.8670424376723749,75.8054895299305000000,2184.479333,0.10226723760906371,1,16475892688,1888.65,2407.88,0.2749212400392,2017-06-01,0.0,0.016129032,0.983871,0.2661452,62,179.43751320050615,181.466616764612,-2.029103564105867
73,2017-06-02,2404.03,2488.55,2373.32,2488.55,2488.55,1317030016,BTC,2103.882381,1633.40700898124,2574.35775301876,0.9088073912874889,82.4338260828995000000,2224.472667,0.11871457757947808,1,17792922704,1987.71,2488.55,0.2519683454830,2017-06-02,0.0,0.0,1.0,0.225274,73,189.36236657901964,183.04576683392804,6.316599745091594
74,2017-06-03,2493.72,2581.91,2423.57,2515.35,2515.35,1514950016,BTC,2137.712857,1655.5050238349693,2619.920690165031,0.8915709337624522,91.8872165706390000000,2259.648667,0.11315977423139825,1,19307872720,2084.73,2515.35,0.2065591227641,2017-06-03,0.014285714,0.0,0.98571426,0.1072143,70,197.11067304482276,185.85874822778263,11.251924817040134
75,2017-06-04,2547.79,2585.89,2452.54,2511.81,2511.81,1355120000,BTC,2171.184286,1687.2561388305494,2655.112433169451,0.8519383156284226,98.2034230931877500000,2288.120667,0.09776116103757914,-1,17952752720,2041.20,2511.81,0.2305555555556,2017-06-04,0.0,0.0,1.0,0.1564423,52,200.6521837337591,188.81743545660362,11.834748277155484
76,2017-06-05,2512.40,2686.81,2510.22,2686.81,2686.81,1369309952,BTC,2216.345238,1725.0823512430597,2707.60812475694,0.9788319804756285,99.8142629281397500000,2331.161333,0.15256287154622258,1,19322062672,2173.40,2686.81,0.2362243489464,2017-06-05,0.015151516,0.0,0.9848485,0.0227576,66,215.06472082876735,194.06689271218846,20.997828116578887
77,2017-06-06,2690.84,2999.91,2690.84,2863.20,2863.20,2089609984,BTC,2270.095238,1753.9123499605357,2786.278126039464,1.074510290580046,99.8142629281397500000,2377.148000,0.20446854802477591,1,21411672656,2320.42,2863.20,0.2339145499522,2017-06-06,0.007352941,0.0,0.99264705,0.1752353,136,237.9431470834602,202.84214382870104,35.10100325475915
78,2017-06-07,2869.38,2869.38,2700.56,2732.16,2732.16,1517709952,BTC,2312.622381,1798.4273823893654,2826.817379610635,0.9079557562146645,95.8401263566210000000,2404.597333,0.13622350091827204,-1,19893962704,2443.64,2732.16,0.1180697647771,2017-06-07,0.0,0.0,1.0,0.3280305,164,242.72369393927784,210.81845402697792,31.90523991229992
79,2017-06-08,2720.49,2815.30,2670.95,2805.62,2805.62,1281170048,BTC,2356.287619,1837.58985687239,2874.9853811276103,0.933135068056699,94.2795967634320000000,2428.729333,0.15518018491358996,1,21175132752,2304.98,2805.62,0.2171992815556,2017-06-08,0.0,0.0,1.0,0.1262703,74,249.5505970791687,218.56488277428363,30.98571430488508
80,2017-06-09,2807.44,2901.71,2795.62,2823.81,2823.81,1348950016,BTC,2396.101905,1867.9587741493172,2924.245035850683,0.904916839788381,93.0849902344932500000,2463.318000,0.14634407737856014,1,22524082768,2202.42,2823.81,0.2821396463890,2017-06-09,0.016949153,0.0,0.9830508,0.0772542,59,253.50287075241022,225.55248046867706,27.950390283733157
81,2017-06-10,2828.14,2950.99,2746.55,2947.71,2947.71,2018889984,BTC,2437.196190,1877.458516746674,2996.9338632533263,0.9560295245384989,93.0849902344932500000,2513.004000,0.17298261363690627,1,24542972752,2038.87,2947.71,0.4457567181821,2017-06-10,0.0,0.0,1.0,0.077493,71,263.57668144718673,233.15732075037315,30.419360696813584
82,2017-06-11,2942.41,2996.60,2840.53,2958.11,2958.11,1752400000,BTC,2480.858571,1907.9650285931857,3053.7521134068147,0.9165271500486746,97.0591268060120000000,2574.286667,0.14909890880462692,1,26295372752,2155.80,2958.11,0.3721634659987,2017-06-11,0.0,0.0,1.0,0.1814186,86,269.2929561660958,240.38444789889616,28.908508267199636
83,2017-06-12,2953.22,2997.26,2518.56,2659.63,2659.63,2569530112,BTC,2504.012381,1944.1542867688004,3063.8704752311996,0.6389795205280502,89.2709970691395000000,2607.875333,0.01984552955622438,-1,23725842640,2255.61,2659.63,0.1791178439535,2017-06-12,0.0,0.0,1.0,-0.0987652,115,246.92592915005343,241.69274415859573,5.233184991457705
84,2017-06-13,2680.91,2789.04,2650.38,2717.02,2717.02,1781200000,BTC,2522.898095,1962.2945920634215,3083.5015979365785,0.6731365430140392,82.7644255340897500000,2638.636000,0.02970625732385975,1,25507042640,2175.47,2717.02,0.2489347129586,2017-06-13,0.0,0.0,1.0,-0.2073158,95,231.15961813039576,239.5861189407592,-8.42650081036345
85,2017-06-14,2716.88,2786.83,2412.94,2506.37,2506.37,1696560000,BTC,2525.885238,1966.3880733380493,3085.3824026619504,0.48256002064658265,65.9511160209142500000,2660.696000,-0.05800211673937947,-1,23810482640,2286.41,2506.37,0.0962032181455,2017-06-14,0.034563288,0.0051377863,0.95913124,0.1536702,4282,199.38932399485202,231.546759914342,-32.157435919489984
86,2017-06-15,2499.58,2534.71,2212.96,2464.58,2464.58,2026259968,BTC,2533.485238,1982.3170904581073,3084.653385541893,0.43749163634790517,43.5273114301067500000,2672.574000,-0.07782534739917398,-1,21784222672,2407.88,2464.58,0.0235476851006,2017-06-15,0.030205168,0.005604103,0.96362084,0.1541384,10528,168.89592992070584,219.01659386918618,-50.12066394848034
87,2017-06-16,2469.57,2539.92,2385.15,2518.56,2518.56,1195190016,BTC,2548.539524,2018.4846318812233,3078.5944161187763,0.47172035911208804,30.7960907469475000000,2679.952667,-0.06022220802155682,1,22979412688,2488.55,2518.56,0.0120592312793,2017-06-16,0.0,0.0,1.0,0.074232,125,147.38187271768447,204.6896495964168,-57.30777687873234
88,2017-06-17,2514.01,2685.19,2484.96,2655.88,2655.88,1534509952,BTC,2577.920952,2100.7582413066866,3055.0836626933133,0.5816902141061341,23.1876625053415000000,2691.108000,-0.01309051884948504,1,24513922640,2515.35,2655.88,0.0558689645576,2017-06-17,0.0,0.0,1.0,0.2858426,108,139.79002962158438,191.70972557066943,-51.91969594908505
89,2017-06-18,2655.35,2662.10,2516.33,2548.29,2548.29,1178659968,BTC,2596.610952,2159.855295097665,3033.366608902335,0.44468193916168863,19.2413424114010000000,2693.304000,-0.05384241808574153,-1,23335262672,2511.81,2548.29,0.0145233914986,2017-06-18,0.013333334,0.0,0.9866667,-0.14468,75,123.67393728254456,178.1025678872298,-54.42863060468525
90,2017-06-19,2549.03,2662.85,2549.03,2589.60,2589.60,1446840064,BTC,2612.515238,2204.5365251426233,3020.4939508573766,0.4719161352322678,22.9980953538790000000,2698.490000,-0.04035219696941623,1,24782102736,2686.81,2589.60,-0.0361804519114,2017-06-19,0.0,0.0,1.0,-0.0815867,75,112.93052883199425,165.06816005640025,-52.13763122440599
91,2017-06-20,2591.26,2763.45,2589.82,2721.79,2721.79,1854189952,BTC,2638.530476,2281.052381763377,2996.0085702366227,0.6164540224175089,33.2928089477842500000,2700.822000,0.00776356235249861,1,26636292688,2863.20,2721.79,-0.0493887957530,2017-06-20,0.0,0.0,1.0,-0.0727778,81,113.76312306571026,154.80715264580368,-41.04402958009342
92,2017-06-21,2709.43,2772.01,2660.40,2689.10,2689.10,1626579968,BTC,2657.706190,2338.3945810988394,2977.0177989011604,0.5491585791509974,34.9755840577067500000,2689.215333,-0.00004288723129930,-1,25009712720,2732.16,2689.10,-0.0157604239869,2017-06-21,0.0,0.0,1.0,-0.0432581,93,110.51297391646085,145.94831689133022,-35.43534297486937
93,2017-06-22,2691.03,2723.74,2642.36,2705.41,2705.41,1097939968,BTC,2671.874286,2373.3959408845512,2970.352631115449,0.5561778007497132,42.9345733795310000000,2687.432000,0.00668965763598856,1,26107652688,2805.62,2705.41,-0.0357175953978,2017-06-22,0.0,0.02631579,0.9736842,-0.0168421,76,108.00724967923043,138.3601034430137,-30.352853763783287
94,2017-06-23,2707.34,2765.17,2706.37,2744.91,2744.91,961318976,BTC,2684.081905,2396.3169004828387,2971.8469095171613,0.6056905705091953,50.8018762790510000000,2683.384667,0.02292825689757882,1,27068971664,2823.81,2744.91,-0.0279409733658,2017-06-23,0.0,0.12631579,0.8736842,-0.1403579,95,107.96215764160434,132.28051427895244,-24.318356637348103
95,2017-06-24,2738.52,2757.94,2583.19,2608.72,2608.72,982750016,BTC,2688.528095,2408.943650037907,2968.1125399620933,0.35727372098469046,45.0742609365185000000,2669.045333,-0.02260183903740387,-1,26086221648,2947.71,2608.72,-0.1150011364754,2017-06-24,0.0,0.028169014,0.97183096,-0.0985493,71,95.83845780287356,124.99210298011195,-29.15364517723839
96,2017-06-25,2607.25,2682.26,2552.12,2589.41,2589.41,1161100032,BTC,2692.223333,2420.508162107145,2963.938503892855,0.3108067859034962,40.0244159422932500000,2645.158667,-0.02107573647490387,-1,24925121616,2958.11,2589.41,-0.1246403953876,2017-06-25,0.0,0.11235955,0.8876405,-0.060764,89,83.70804840861229,116.73529206252697,-33.02724365391468
97,2017-06-26,2590.57,2615.25,2376.29,2478.45,2478.45,1663280000,BTC,2682.301429,2394.9869405880363,2969.615917411964,0.14524686846333104,29.0619912684297500000,2613.181333,-0.05155835582421099,-1,23261841616,2659.63,2478.45,-0.0681222576073,2017-06-26,0.011363637,0.056818184,0.9318182,-0.0996364,88,64.40306244907833,106.2688461365059,-41.865783687427566
98,2017-06-27,2478.45,2552.45,2332.99,2552.45,2552.45,1489789952,BTC,2667.503810,2387.40139426774,2947.60622573226,0.2946218891057758,22.6980400921510000000,2606.036000,-0.02056226391346858,1,24751631568,2717.02,2552.45,-0.0605700362898,2017-06-27,0.0,0.0,1.0,0.0663455,110,54.44461316309798,95.90399953918512,-41.45938637608714
99,2017-06-28,2553.03,2603.98,2484.42,2574.79,2574.79,1183869952,BTC,2660.010000,2378.754620247007,2941.2653797529933,0.3485006756584656,25.2251537961907500000,2596.554000,-0.00838187844350628,1,25935501520,2506.37,2574.79,0.0272984435658,2017-06-28,0.0056179776,0.016853932,0.9775281,0.1719101,178,47.803314108469294,86.28386245108229,-38.48054834261299
100,2017-06-29,2567.56,2588.83,2510.48,2539.32,2539.32,949979008,BTC,2647.329048,2369.656647649892,2925.001448350108,0.30550993209297217,25.5671886704957500000,2598.750667,-0.02286893766095953,-1,24985522512,2464.58,2539.32,0.0303256538639,2017-06-29,0.0,0.019607844,0.98039216,0.0284118,102,39.22683239155049,76.87245643764221,-37.645624046091726
101,2017-06-30,2539.24,2559.25,2478.43,2480.84,2480.84,860273024,BTC,2630.997143,2356.595418286553,2905.398867713447,0.22639176529082242,24.5544899127705000000,2599.834667,-0.04577009011781133,-1,24125249488,2518.56,2480.84,-0.0149768121466,2017-06-30,0.0,0.03448276,0.9655172,-0.0911724,58,27.39696002509072,66.9773571538419,-39.58039712875117
102,2017-07-01,2492.60,2515.27,2419.23,2434.55,2434.55,779913984,BTC,2606.560952,2360.704773236499,2852.4171307635006,0.1501797252664045,16.7181898378587500000,2594.234000,-0.06155342964435745,-1,23345335504,2655.88,2434.55,-0.0833358434869,2017-07-01,0.023255814,0.034883723,0.94186044,-0.0293023,86,14.124936970658382,56.40687311610274,-42.281936145444355
103,2017-07-02,2436.40,2514.28,2394.84,2506.47,2506.47,803747008,BTC,2585.054286,2395.874742648037,2774.233829351963,0.29230236893585115,12.6828672964355000000,2584.273333,-0.03010646436136870,1,24149082512,2548.29,2506.47,-0.0164110050269,2017-07-02,0.0,0.0,1.0,-0.1071154,52,9.301121939185123,46.98572287993315,-37.68460094074803
104,2017-07-03,2498.56,2595.00,2480.47,2564.06,2564.06,964112000,BTC,2580.503333,2394.28368502124,2766.72298097876,0.455849629245686,16.4497485914065000000,2585.324667,-0.00822514373975143,1,25113194512,2589.60,2564.06,-0.0098625270312,2017-07-03,0.0,0.0125,0.9875,-0.033225,80,10.008547244996862,39.590287752452255,-29.581740507455393
105,2017-07-04,2561.00,2631.59,2559.35,2601.64,2601.64,985516032,BTC,2575.009048,2399.188222054407,2750.8298739455927,0.575733212652069,29.6848820724317500000,2586.127333,0.00599841577870211,1,26098710544,2721.79,2601.64,-0.0441437436393,2017-07-04,0.015384615,0.015384615,0.9692308,-0.0822923,65,13.445770652934698,34.361384332269516,-20.915613679334818
106,2017-07-05,2602.87,2622.65,2538.55,2601.99,2601.99,941566016,BTC,2579.562381,2406.272982950984,2752.8517790490164,0.5647114574016114,43.1724449026935000000,2578.140667,0.00925059416084995,-1,25157144528,2689.10,2601.99,-0.0323937376818,2017-07-05,0.0,0.0,1.0,-0.0825455,77,16.01342234930098,30.69179193551905,-14.678369586218068
107,2017-07-06,2608.10,2616.72,2581.69,2608.56,2608.56,761956992,BTC,2586.418571,2421.0227808134646,2751.8143611865357,0.5669346812728074,51.3959595308672500000,2572.771333,0.01391055106256503,1,25919101520,2705.41,2608.56,-0.0357986405018,2017-07-06,0.0,0.0,1.0,-0.0231848,92,18.366596388885682,28.226752826108136,-9.860156437222454
108,2017-07-07,2608.59,2916.14,2498.87,2518.66,2518.66,917411968,BTC,2586.423333,2421.0357428569264,2751.810923143074,0.29513779437326737,47.7389160974352500000,2560.321333,-0.01627191574082002,-1,25001689552,2744.91,2518.66,-0.0824252889894,2017-07-07,0.0,0.0,1.0,-0.0899765,85,12.830937631469169,25.14758978709616,-12.31665215562699
109,2017-07-08,2520.27,2571.34,2492.31,2571.34,2571.34,733329984,BTC,2582.397619,2420.0226089886364,2744.7726290113633,0.4659503669954328,53.9140987820475000000,2548.750000,0.00886316821971555,1,25735019536,2608.72,2571.34,-0.0143288662639,2017-07-08,0.0,0.0,1.0,-0.0413511,94,12.549239346614286,22.627919698944673,-10.078680352330387
110,2017-07-09,2572.61,2635.49,2517.59,2518.44,2518.44,527856000,BTC,2580.976190,2416.8341557155195,2745.11822428448,0.30950586401404007,52.4790042007370000000,2542.731333,-0.00955324405875798,-1,25207163536,2589.41,2518.44,-0.0274077878745,2017-07-09,0.0,0.0,1.0,-0.1074643,56,7.966341633905358,19.6956040858855,-11.72926245198014
111,2017-07-10,2525.25,2537.16,2321.13,2372.56,2372.56,1111200000,BTC,2570.640952,2383.1134524800887,2758.1684515199117,-0.02813841305170325,38.4622172436550000000,2528.274667,-0.06158930002046332,-1,24095963536,2478.45,2372.56,-0.0427242833222,2017-07-10,0.0,0.0,1.0,-0.0569412,68,-7.350226952862158,14.286437878060248,-21.636664830922406
112,2017-07-11,2385.89,2413.47,2296.81,2337.79,2337.79,1329760000,BTC,2552.355238,2352.262943033998,2752.447532966002,-0.03616566803948435,31.6870206977082500000,2518.897333,-0.07189945005988063,-1,22766203536,2552.45,2337.79,-0.0840995905894,2017-07-11,0.011363637,0.011363637,0.97727275,-0.0634205,88,-22.03984250135818,7.021181802095202,-29.061024303453383
113,2017-07-12,2332.77,2423.71,2275.14,2398.84,2398.84,1117410048,BTC,2538.533333,2338.013765442783,2739.0529005572166,0.15167156826193717,17.6891709855912500000,2508.656667,-0.04377508825523154,1,23883613584,2574.79,2398.84,-0.0683356700935,2017-07-12,0.014084507,0.0,0.97183096,-0.0610141,71,-28.428221297339405,-0.06869881785523631,-28.35952247948417
114,2017-07-13,2402.70,2425.22,2340.83,2357.90,2357.90,835769984,BTC,2521.985238,2321.9500233382764,2722.020452661724,0.08985911986176552,7.4934446208960000000,2494.197333,-0.05464576968176880,-1,23047843600,2539.32,2357.90,-0.0714443236772,2017-07-13,0.0,0.0,1.0,0.0182154,65,-36.37481165249255,-7.3299213848347415,-29.044890267657813
115,2017-07-14,2360.59,2363.25,2183.22,2233.34,2233.34,882502976,BTC,2497.624762,2287.2779195117846,2707.9716044882152,-0.1282118592172505,7.4934446208960000000,2473.798667,-0.09720219765968529,-1,22165340624,2480.84,2233.34,-0.0997645958627,2017-07-14,0.0,0.0,1.0,-0.0795714,77,-52.121412522764786,-16.288219612472115,-35.83319291029267
116,2017-07-15,2230.12,2231.14,1990.41,1998.86,1998.86,993608000,BTC,2468.583810,2171.9553584666933,2765.212261533307,-0.2917713347656697,7.4934446208960000000,2441.666667,-0.18135426632336461,-1,21171732624,2434.55,1998.86,-0.1789612043293,2017-07-15,0.011494253,0.0,0.9885057,-0.075931,87,-82.56731049075142,-29.54403778818878,-53.02327270256264
117,2017-07-16,1991.98,2058.77,1843.03,1929.82,1929.82,1182870016,BTC,2437.174762,2064.376539975321,2809.972984024679,-0.18046832311128025,1.8567418842560000000,2408.018000,-0.19858572485753844,-1,19988862608,2506.47,1929.82,-0.2300645928337,2017-07-16,0.0,0.0,1.0,-0.0868276,87,-110.98682973861514,-45.83259617833383,-65.15423356028131
118,2017-07-17,1932.62,2230.49,1932.62,2228.41,2228.41,1201760000,BTC,2425.268095,2042.176850170831,2808.359339829169,0.2430663090619774,10.9979520876920000000,2389.480667,-0.06740823193276751,1,21190622608,2564.06,2228.41,-0.1309056730342,2017-07-17,0.0,0.0,1.0,-0.0515567,97,-108.17116371740303,-58.30030968618427,-49.87085403121876
119,2017-07-18,2233.52,2387.61,2164.77,2318.88,2318.88,1512450048,BTC,2414.145714,2033.005360661683,2795.2860673383175,0.3750254162730468,25.3281816306687500000,2373.135333,-0.02286230045355782,1,22703072656,2601.64,2318.88,-0.1086852908166,2017-07-18,0.0,0.0,1.0,-0.0567529,85,-97.51609576392912,-66.14346690175165,-31.372628862177464
120,2017-07-19,2323.08,2397.17,2260.23,2273.43,2273.43,1245100032,BTC,2399.795238,2021.3749661001436,2778.2155098998564,0.3330358501070987,37.9843533606390000000,2351.254667,-0.03309920787921184,-1,21457972624,2601.99,2273.43,-0.1262725836763,2017-07-19,0.0,0.0,1.0,-0.0878831,77,-91.68214442942099,-71.25120240729511,-20.430942022125876
121,2017-07-20,2269.89,2900.70,2269.89,2817.60,2817.60,2249260032,BTC,2413.046667,1996.5336268039778,2829.5597071960224,0.9856430579095508,62.9843533606390000000,2365.628667,0.19105759889745198,1,23707232656,2608.56,2817.60,0.0801361670807,2017-07-20,0.0,0.0,1.0,-0.0181942,103,-42.6603635603019,-65.53303463788787,22.872671077585963
122,2017-07-21,2838.41,2838.41,2621.85,2667.76,2667.76,1489449984,BTC,2421.947619,1991.5908499395023,2852.304388060498,0.785591396106802,72.7668874294272500000,2369.575333,0.12583886354964854,-1,22217782672,2518.66,2667.76,0.0591981450454,2017-07-21,0.0,0.0,1.0,-0.0940217,92,-15.719046760312722,-55.57023706236086,39.85119030204814
123,2017-07-22,2668.63,2862.42,2657.71,2810.12,2810.12,1177129984,BTC,2439.831905,1977.2658190136171,2902.397990986383,0.900254262275186,83.2260201158317500000,2389.006000,0.17627163766018168,1,23394912656,2571.34,2810.12,0.0928620874719,2017-07-22,0.0,0.0,1.0,-0.0666875,96,16.923537845050305,-41.07148208086468,57.99501992591499
124,2017-07-23,2808.10,2832.18,2653.94,2730.40,2730.40,1072840000,BTC,2450.495238,1971.4465428710373,2929.5439331289626,0.7921464611490573,93.1142850706257500000,2399.610000,0.13785156754639296,-1,22322072656,2518.44,2730.40,0.0841632121472,2017-07-23,0.012048192,0.0,0.9879518,-0.1008313,83,35.94629085860379,-25.667927492959137,61.614218351562926
125,2017-07-24,2732.70,2777.26,2699.19,2754.86,2754.86,866473984,BTC,2459.580952,1964.516176363326,2954.6457276366737,0.7982226392700422,91.3475185293655000000,2415.371333,0.14055340574831605,1,23188546640,2372.56,2754.86,0.1611339649998,2017-07-24,0.0,0.0,1.0,-0.0072232,112,52.39161163974677,-10.056019666408346,62.44763130615512
126,2017-07-25,2757.50,2768.08,2480.96,2576.48,2576.48,1460089984,BTC,2458.382857,1964.642007843568,2952.123706156432,0.6195942600270686,88.7770618847012500000,2428.966000,0.06073119179107489,-1,21728456656,2337.79,2576.48,0.1021007019450,2017-07-25,0.0,0.0054945056,0.99450547,0.1692802,182,50.4500611923836,2.0451965053559995,48.4048646870276
127,2017-07-26,2577.77,2610.76,2450.80,2529.45,2529.45,937404032,BTC,2454.928571,1964.4029174288248,2945.454224571175,0.575960786614789,80.8733582644347500000,2441.743333,0.03591969140025906,-1,20791052624,2398.84,2529.45,0.0544471494556,2017-07-26,0.0,0.0,1.0,0.1845955,178,44.602473010965696,10.55665180648129,34.045821204484405
128,2017-07-27,2538.71,2693.32,2529.34,2671.78,2671.78,789104000,BTC,2457.939048,1962.6999768472988,2953.1781191527016,0.7158966895546742,79.2226114577935000000,2459.939333,0.08611621602133226,1,21580156624,2357.90,2671.78,0.1331184528606,2017-07-27,0.0,0.0,1.0,0.0352313,160,50.86618364356082,18.618558173899732,32.24762546966109
129,2017-07-28,2679.73,2897.45,2679.73,2809.01,2809.01,1380099968,BTC,2471.765238,1953.7192876975564,2989.8111883024435,0.8254969581396316,80.7474824843992500000,2490.013333,0.12811042526253011,1,22960256592,2233.34,2809.01,0.2577619171286,2017-07-28,0.0,0.0,1.0,-0.1375985,132,66.14063424818869,28.12297338875992,38.01766085942877
130,2017-07-29,2807.02,2808.76,2692.80,2726.45,2726.45,803745984,BTC,2479.151429,1950.8216918363341,3007.481166163666,0.7340380955344481,84.9706571447880000000,2522.887333,0.08068638830491920,-1,22156510608,1998.86,2726.45,0.3640024814144,2017-07-29,0.0,0.0,1.0,-0.1472803,132,70.76831905906101,36.65204252282186,34.116276536239155
131,2017-07-30,2724.39,2758.53,2644.85,2757.18,2757.18,705942976,BTC,2490.520000,1948.5414547050775,3032.498545294922,0.7460060479468745,91.3835634954605000000,2573.442000,0.07139776221884931,1,22862453584,1929.82,2757.18,0.4287239224384,2017-07-30,0.0,0.0,1.0,-0.1546709,79,76.0388228865736,44.529398595573475,31.509424291000123
132,2017-07-31,2763.24,2889.62,2720.61,2875.34,2875.34,860574976,BTC,2514.461905,1950.3984196149222,3078.525390385078,0.8198913813341718,95.4898736173375000000,2636.476667,0.09059944887424259,1,23723028560,2228.41,2875.34,0.2903101314390,2017-07-31,0.033898305,0.0,0.9661017,-0.1270593,118,88.7271442604092,53.36894772854177,35.358196531867435
133,2017-08-01,2871.30,2921.35,2685.61,2718.26,2718.26,1324669952,BTC,2532.579524,1967.9087227546656,3097.250325245335,0.6644148020319955,89.2075379346370000000,2669.133333,0.01840547506286753,-1,22398358608,2318.88,2718.26,0.1722296970951,2017-08-01,0.008196721,0.0,0.9918033,-0.0938033,122,85.12678024901152,59.72051423263637,25.40626601637515
134,2017-08-02,2727.13,2762.53,2668.59,2710.67,2710.67,1094950016,BTC,2547.428571,1981.13091996176,3113.72622203824,0.6441304133088988,84.9348560996587500000,2695.252667,0.00572018096439194,-1,21303408592,2273.43,2710.67,0.1923261327598,2017-08-02,0.0,0.009090909,0.9909091,-0.0872,110,80.73042021257788,63.92249542862503,16.807924783952856
135,2017-08-03,2709.56,2813.31,2685.14,2804.73,2804.73,804796992,BTC,2568.706190,1998.7516979402844,3138.6606820597153,0.7070549607803349,81.5327900268007500000,2730.672667,0.02712054575232616,1,22108205584,2817.60,2804.73,-0.0045677172061,2017-08-03,0.0,0.0,1.0,-0.1202268,97,83.86913448825817,67.91182324055191,15.957311247706258
136,2017-08-04,2806.93,2899.33,2743.72,2895.89,2895.89,1002120000,BTC,2600.256190,2034.9393007962117,3165.5730792037884,0.761476187644403,81.5327900268007500000,2735.892000,0.05848110963444463,1,23110325584,2667.76,2895.89,0.0855136893874,2017-08-04,0.0,0.0,1.0,-0.0562321,112,92.64430769306455,72.85832013105468,19.785987562009865
137,2017-08-05,2897.63,3290.01,2874.83,3252.91,3252.91,1945699968,BTC,2659.972857,2096.535574344943,3223.4101396550573,1.0261784774038487,88.0570212241557500000,2774.902000,0.17226121859438640,1,25056025552,2810.12,3252.91,0.1575697834968,2017-08-05,0.0,0.0,1.0,-0.0963879,116,126.94324430767529,83.67530496637926,43.26793934129603
138,2017-08-06,3257.61,3293.29,3155.60,3213.94,3213.94,1105030016,BTC,2721.121429,2214.654815202576,3227.5880427974234,0.9865262167084499,93.5498453055287500000,2801.823333,0.14708874115868461,-1,23950995536,2730.40,3213.94,0.1770949311456,2017-08-06,0.0,0.04347826,0.95652175,-0.1199826,115,149.26031886838337,96.79230774678051,52.468011121602856
139,2017-08-07,3212.78,3397.68,3180.89,3378.94,3378.94,1482279936,BTC,2775.908571,2244.9719224142873,3306.8452195857126,1.0678939574112378,98.6533464185995000000,2845.059333,0.18765185696041159,1,25433275472,2754.86,3378.94,0.2265378276936,2017-08-07,0.0,0.011764706,0.9882353,0.0267824,170,178.20636163246718,113.07511852391828,65.1312431085489
140,2017-08-08,3370.22,3484.85,3345.83,3419.94,3419.94,1752760064,BTC,2828.340000,2270.1930943918082,3386.486905608192,1.0299680013054586,98.6533464185995000000,2889.398000,0.18361679491714191,1,27186035536,2576.48,3419.94,0.3273691237658,2017-08-08,0.0,0.04255319,0.9432624,-0.0909929,141,202.1246285833422,130.88502053580342,71.23960804753878
141,2017-08-09,3420.40,3422.76,3247.67,3342.47,3342.47,1468960000,BTC,2879.246667,2338.946171522406,3419.5471624775937,0.9286719491072628,96.4784202543527500000,2940.464000,0.13671515787984481,-1,25717075536,2529.45,3342.47,0.3214216529285,2017-08-09,0.0,0.032258064,0.96313363,0.1929217,217,212.38074655349146,147.18416573934132,65.19658081415014
142,2017-08-10,3341.84,3453.45,3319.47,3381.28,3381.28,1515110016,BTC,2906.088571,2324.241505448038,3487.9356365519616,0.9083473623341352,96.5332378648380000000,2997.252667,0.12812644633806577,1,27232185552,2671.78,3381.28,0.2655533015443,2017-08-10,0.0,0.0,1.0,0.0922672,131,221.09177216443186,161.96568702435962,59.126085140072234
143,2017-08-11,3373.82,3679.72,3372.12,3650.62,3650.62,2021190016,BTC,2952.891429,2298.024126035935,3607.7587319640647,1.0327251550367045,96.5332378648380000000,3062.508667,0.19203581016347210,1,29253375568,2809.01,3650.62,0.2996108949416,2017-08-11,0.016666668,0.025,0.9583333,-0.0205333,120,246.8825833838,178.94906629624785,67.93351708755216
144,2017-08-12,3650.63,3949.92,3613.70,3884.71,3884.71,2219589888,BTC,3004.062381,2237.619911145811,3770.5048508541895,1.0745034060857415,96.5332378648380000000,3134.222000,0.23944953484469192,1,31472965456,2726.45,3884.71,0.4248234884190,2017-08-12,0.032185204,0.009599096,0.957651,0.1486855,1771,282.9491723278734,199.74908750257313,83.20008482530025
145,2017-08-13,3880.04,4208.39,3857.80,4073.26,4073.26,3159089920,BTC,3068.008095,2182.6163618192786,3953.3998281807217,1.0676876501820767,98.7081640290847500000,3224.009333,0.26341445674716972,1,34632055376,2757.18,4073.26,0.4773282846967,2017-08-13,0.037413977,0.009111175,0.95289326,0.1991304,10317,323.0228098809139,224.40383197824144,98.61897790267244
146,2017-08-14,4066.10,4325.13,3989.16,4325.13,4325.13,2463089920,BTC,3142.782857,2114.7293764428287,4170.836337557172,1.0750416517043482,100.0000000000000000000,3328.539333,0.29940780844003925,1,37095145296,2875.34,4325.13,0.5042151536862,2017-08-14,0.015151516,0.0,0.9848485,0.031303,132,370.8303173195386,253.68912904650105,117.14118827303756
147,2017-08-15,4326.99,4455.97,3906.18,4181.93,4181.93,3258050048,BTC,3219.232857,2131.0360916649274,4307.429622335072,0.942335969774534,97.7825402921100000000,3415.645333,0.22434550203342204,-1,33837095248,2718.26,4181.93,0.5384584256105,2017-08-15,0.014184397,0.0,0.9858156,-0.0091702,141,392.63710087830395,281.47872341286177,111.15837746544219
148,2017-08-16,4200.34,4381.23,3994.42,4376.63,4376.63,2272039936,BTC,3307.193810,2156.3550684992424,4458.032551500758,0.9646333806096046,97.7825402921100000000,3526.203333,0.24117346241530536,1,36109135184,2710.67,4376.63,0.6145934399982,2017-08-16,0.0076923077,0.015384615,0.97692305,0.0090308,130,420.7791545371865,309.3388096377268,111.44034489945972
149,2017-08-17,4384.44,4484.70,4243.71,4331.69,4331.69,2553359872,BTC,3386.237143,2191.516593228751,4580.957692771249,0.8956794989343005,97.0678001686925000000,3634.271333,0.19190054982061517,-1,33555775312,2804.73,4331.69,0.5444231708578,2017-08-17,0.0074626864,0.03731343,0.95522386,0.0221194,134,434.4476334101669,334.36057439221486,100.08705901795201
150,2017-08-18,4324.34,4370.13,4015.40,4160.62,4160.62,2941710080,BTC,3450.599524,2240.949098670828,4660.2499493291725,0.7934816791416361,93.4208060981602500000,3724.664000,0.11704572546678036,-1,30614065232,2895.89,4160.62,0.4367327488268,2017-08-18,0.0,0.024,0.976,-0.004176,125,426.5590815689866,352.80027582756924,73.75880574141735
151,2017-08-19,4137.75,4243.26,3970.55,4193.70,4193.70,2975820032,BTC,3520.468571,2317.010122838441,4723.927019161559,0.7797069687069169,91.7049301791850000000,3811.184667,0.10036651761120239,1,33589885264,3252.91,4193.70,0.2892148875930,2017-08-19,0.0,0.0,1.0,-0.0067481,131,418.15635462249656,365.8714915865548,52.28486303594178
152,2017-08-20,4189.31,4196.29,4069.88,4087.66,4087.66,2109769984,BTC,3583.824762,2409.400331793969,4758.249192206031,0.7145030472125019,85.4915370993442500000,3866.834667,0.05710751868564439,-1,31480115280,3213.94,4087.66,0.2718532393262,2017-08-20,0.0,0.0,1.0,0.0062677,127,398.34873112201467,372.3669394936468,25.981791628367887
153,2017-08-21,4090.48,4109.14,3988.60,4001.74,4001.74,2800890112,BTC,3637.462857,2496.529182395857,4778.396531604143,0.6596399296069462,77.1436080032985000000,3919.354667,0.02102012703613281,-1,28679225168,3378.94,4001.74,0.1843181589493,2017-08-21,0.008333334,0.0,0.9916667,0.02995,120,371.4363757922915,372.1808267533757,-0.7444509610841692
154,2017-08-22,3998.35,4128.76,3674.58,4100.52,4100.52,3764239872,BTC,3703.284762,2627.4452490498747,4779.124274950125,0.684616401060934,74.1158612213515000000,3967.460000,0.03353783024907624,1,32443465040,3419.94,4100.52,0.1990034912893,2017-08-22,0.0,0.0,1.0,0.0284366,142,353.9981391729466,368.54428923728983,-14.546150064343237
155,2017-08-23,4089.01,4255.78,4078.41,4151.52,4151.52,2369819904,BTC,3771.896667,2781.550809406132,4762.242524593868,0.6916619987295793,72.6073406557512500000,4016.232000,0.03368530503217942,1,34813284944,3342.47,4151.52,0.2420515367378,2017-08-23,0.0,0.0,1.0,0.0406018,113,340.369886520672,362.90940869396627,-22.539522173294245
156,2017-08-24,4137.60,4376.39,4130.26,4334.68,4334.68,2037750016,BTC,3844.751429,2931.102244196867,4758.400613803133,0.7681163509742347,77.7670842655562500000,4082.379333,0.06180235750277349,1,36851034960,3381.28,4334.68,0.2819642265651,2017-08-24,0.009803922,0.05882353,0.9313725,0.0162549,102,340.4245963010462,358.41244621538226,-17.98784991433604
157,2017-08-25,4332.82,4455.70,4307.35,4371.60,4371.60,1727970048,BTC,3915.023333,3084.685495916002,4745.361170083998,0.774934277717259,86.6565465043995000000,4148.400667,0.05380370675752762,1,38579005008,3650.62,4371.60,0.1974952199900,2017-08-25,0.009433962,0.0,0.990566,0.0240094,106,339.5331452953624,354.63658603137833,-15.103440736015955
158,2017-08-26,4372.06,4379.28,4269.52,4352.40,4352.40,1511609984,BTC,3967.380000,3174.582009412233,4760.177990587767,0.7428235216101847,92.0998879423397500000,4195.186000,0.03747485808734106,-1,37067395024,3884.71,4352.40,0.1203925132121,2017-08-26,0.013157895,0.0,0.9868421,-0.0316053,76,333.4337715916072,350.39602314342415,-16.962251551816962
159,2017-08-27,4345.10,4416.59,4317.29,4382.88,4382.88,1537459968,BTC,4023.043810,3290.576195385506,4755.511424614494,0.7456328326470694,97.5417441348052500000,4228.397333,0.03653456731569649,1,38604854992,4073.26,4382.88,0.0760128251081,2017-08-27,0.0,0.011235955,0.98876405,0.0441011,89,327.28668547129473,345.7741556089983,-18.487470137703554
160,2017-08-28,4384.45,4403.93,4224.64,4382.66,4382.66,1959330048,BTC,4070.840000,3385.4169004476144,4756.263099552386,0.7274653423583427,98.5809632118095000000,4249.024000,0.03145098733262039,-1,36645524944,4325.13,4382.66,0.0133013342952,2017-08-28,0.009433962,0.0,0.990566,0.0049151,106,318.7232776646774,340.36398002013414,-21.64070235545671
161,2017-08-29,4389.21,4625.68,4352.13,4579.02,4579.02,2486080000,BTC,4126.034286,3474.938957078914,4777.129614921087,0.8478643555549933,98.7541701924295000000,4265.950000,0.07338810815879230,1,39131604944,4181.93,4579.02,0.0949537653667,2017-08-29,0.0,0.0,1.0,-0.0108857,105,324.04586871458787,337.1003577590249,-13.054489044437048
162,2017-08-30,4570.36,4626.52,4471.41,4565.30,4565.30,1937849984,BTC,4184.264286,3613.755456319988,4754.773115680012,0.8339437482621578,99.3914038641747500000,4291.508000,0.06379855286300294,-1,37193754960,4376.63,4565.30,0.0431085104293,2017-08-30,0.0,0.023041476,0.97235024,0.1673364,217,323.42868800944643,334.36602380910927,-10.937335799662833
163,2017-08-31,4555.59,4736.05,4549.40,4703.39,4703.39,1944930048,BTC,4247.221905,3763.7195844008515,4730.72422559915,0.9717330978212503,99.3914038641747500000,4313.292000,0.09044089757892579,1,39138685008,4331.69,4703.39,0.0858094646662,2017-08-31,0.0,0.028806584,0.97119343,0.1902551,243,330.275035777237,333.5478262027348,-3.272790425497817
164,2017-09-01,4701.76,4892.01,4678.53,4892.01,4892.01,2599079936,BTC,4306.335714,3825.6472425105567,4787.024185489443,1.1092035910339728,99.4058342572062500000,4350.646667,0.12443284284754352,1,41737764944,4160.62,4892.01,0.1757887045681,2017-09-01,0.0088495575,0.0,0.99115044,0.2458805,226,346.9217304427548,336.2226070507389,10.699123392015906
165,2017-09-02,4901.42,4975.04,4469.24,4578.77,4578.77,2722139904,BTC,4339.386190,3885.773973080032,4792.998406919968,0.7638639360569023,90.6096263652185000000,4378.523333,0.04573383576393973,-1,39015625040,4193.70,4578.77,0.0918210649307,2017-09-02,0.006134969,0.0,0.993865,0.1984601,163,331.02274583084363,335.18263480675984,-4.159888975916203
166,2017-09-03,4585.27,4714.08,4417.59,4582.96,4582.96,1933190016,BTC,4363.657619,3915.3376169967523,4811.977621003247,0.7445824188303916,82.5252451503477500000,4404.474000,0.04052379466878451,-1,37082435024,4087.66,4582.96,0.1211695688976,2017-09-03,0.0,0.0,1.0,0.154304,227,315.128180521845,331.1717439497769,-16.043563427931872
167,2017-09-04,4591.63,4591.63,4108.40,4236.31,4236.31,2987330048,BTC,4359.428095,3907.9169670476967,4810.939222952304,0.363659955006684,64.1122917766522500000,4414.384000,-0.04033949017575272,-1,34095104976,4001.74,4236.31,0.0586170016043,2017-09-04,0.016666668,0.0,0.98333335,0.0253833,120,271.4310390535329,319.22360297052813,-47.79256391699522
168,2017-09-05,4228.29,4427.84,3998.11,4376.53,4376.53,2697969920,BTC,4368.694762,3924.556247272036,4812.8332767279635,0.5088207144169865,47.8303425416650000000,4439.370000,-0.01415516165582053,1,36793074896,4100.52,4376.53,0.0673109751934,2017-09-05,0.010638298,0.0,0.9893617,0.0385106,94,245.2877732696561,304.4364370303538,-59.14866376069767
169,2017-09-06,4376.59,4617.25,4376.59,4597.12,4597.12,2172100096,BTC,4379.194286,3923.9811089687782,4834.407463031222,0.7393666582998026,46.6706428589387500000,4472.476667,0.02786897334080603,1,38965174992,4151.52,4597.12,0.1073341812156,2017-09-06,0.009090909,0.0,0.9909091,0.1139636,110,239.60674410093543,291.47049844447014,-51.86375434353471
170,2017-09-07,4589.14,4655.04,4491.33,4599.88,4599.88,1844620032,BTC,4391.965238,3927.3975533029666,4856.5329226970325,0.7237723036370812,44.2110931260435000000,4502.367333,0.02165808779867496,1,40809795024,4334.68,4599.88,0.0611809868318,2017-09-07,0.0,0.0,1.0,0.0536741,135,232.64540398988538,279.7054795535532,-47.060075563667795
171,2017-09-08,4605.16,4661.00,4075.18,4228.75,4228.75,2700890112,BTC,4395.209524,3936.5128421076533,4853.906205892346,0.3185516370935217,37.6240464997390000000,4495.305333,-0.05929637994625626,-1,38108904912,4371.60,4228.75,-0.0326768231311,2017-09-08,0.0,0.0,1.0,0.1422202,109,194.93436936598118,262.7512575160388,-67.8168881500576
172,2017-09-09,4229.81,4308.82,4114.11,4226.06,4226.06,1386230016,BTC,4396.750476,3940.6871387549986,4852.813813245002,0.31286538287520427,28.9059957347262500000,4485.602667,-0.05786126999375623,-1,36722674896,4352.40,4226.06,-0.0290276628986,2017-09-09,0.0088495575,0.0,0.99115044,0.0989204,113,162.95262614345938,242.7915312415229,-79.83890509806352
173,2017-09-10,4229.34,4245.44,3951.04,4122.94,4122.94,1679090048,BTC,4398.430476,3946.9119665465705,4849.94898545343,0.1949289229211375,13.8619033094402500000,4470.305333,-0.07770505751267885,-1,35043584848,4382.88,4122.94,-0.0593080348994,2017-09-10,0.0,0.0,1.0,-0.0032315,108,127.81260967430444,219.7957469280792,-91.98313725377477
174,2017-09-11,4122.47,4261.67,4099.40,4161.27,4161.27,1557330048,BTC,4406.027143,3977.7714522663987,4834.282833733602,0.2142394738751385,1.2459854109510000000,4455.531333,-0.06604404974566027,1,36600914896,4382.66,4161.27,-0.0505149840508,2017-09-11,0.0,0.0,1.0,0.1497315,108,101.88236374255666,196.2130702909747,-94.33070654841805
175,2017-09-12,4168.88,4344.65,4085.22,4130.81,4130.81,1864530048,BTC,4407.469524,3983.3514142958193,4831.587633704181,0.17384141625906094,1.5018138791007500000,4438.741333,-0.06937357009534937,-1,34736384848,4579.02,4130.81,-0.0978833898957,2017-09-12,0.007633588,0.0,0.9847328,0.0547939,131,77.97573691621437,172.56560361602266,-94.58986669980828
176,2017-09-13,4131.98,4131.98,3789.92,3882.59,3882.59,2219409920,BTC,4394.663333,3924.3601878124164,4864.9664781875845,-0.04440772748368062,1.5018138791007500000,4392.312667,-0.11604881201413797,-1,32516974928,4565.30,3882.59,-0.1495432939785,2017-09-13,0.024590164,0.0,0.97540987,0.0996803,122,38.5558581276473,145.76365451834758,-107.20779639070028
177,2017-09-14,3875.37,3920.60,3153.86,3154.95,3154.95,2716310016,BTC,4338.485714,3621.1375463834256,5055.833881616575,-0.32493813146017875,1.5018138791007500000,4298.289333,-0.26599869027476657,-1,29800664912,4703.39,3154.95,-0.3292178620102,2017-09-14,0.0,0.0,1.0,0.0088411,107,-50.813340513456296,106.4482555119868,-157.2615960254431
178,2017-09-15,3166.30,3733.45,2946.62,3637.52,3637.52,4148069888,BTC,4303.529524,3524.101823145681,5082.957224854318,0.07275734281063084,7.2010404930655000000,4227.231333,-0.13950297169601340,1,33948734800,4892.01,3637.52,-0.2564365158698,2017-09-15,0.0,0.0,1.0,0.096208,125,-81.75729770621501,68.80714486834644,-150.56444257456144
179,2017-09-16,3637.75,3808.84,3487.79,3625.04,3625.04,1818400000,BTC,4268.893333,3435.7901658872265,5101.996500112773,0.11358127155406407,15.0786510150397500000,4142.766667,-0.12497123507438900,-1,32130334800,4578.77,3625.04,-0.2082939304660,2017-09-16,0.0,0.0,1.0,0.1098125,128,-106.06498596161191,33.83271870235476,-139.89770466396666
180,2017-09-17,3606.28,3664.81,3445.64,3582.88,3582.88,1239149952,BTC,4230.798095,3347.9108340064117,5113.685355993589,0.13306861270665377,22.4826429039202500000,4076.374000,-0.12106200265235722,-1,30891184848,4582.96,3582.88,-0.2182170474977,2017-09-17,0.0,0.0,1.0,0.0127536,138,-127.26394100217476,1.6133867614488457,-128.8773277636236
181,2017-09-18,3591.09,4079.23,3591.09,4065.20,4065.20,1943209984,BTC,4215.680952,3332.8433473431796,5098.51855665682,0.41477427377003534,38.2316757290397500000,4041.856667,0.00577539851687175,1,32834394832,4236.31,4065.20,-0.0403912839240,2017-09-18,0.008547009,0.0,0.991453,0.0139829,117,-103.94686723012592,-19.498664036866117,-84.4482031932598
182,2017-09-19,4073.79,4094.07,3868.87,3924.97,3924.97,1563980032,BTC,4184.535714,3309.4199236825943,5059.651504317405,0.3516963601434645,44.6092544275500000000,4021.100667,-0.02390655568235740,-1,31270414800,4376.53,3924.97,-0.1031776315940,2017-09-19,0.0,0.008196721,0.9836066,0.1258525,122,-95.68035574061832,-34.73500237761657,-60.94535336300176
183,2017-09-20,3916.36,4031.39,3857.73,3905.95,3905.95,1213830016,BTC,4153.138095,3288.1450579038833,5018.131132096117,0.35711555792989985,49.4695244752340000000,3989.728667,-0.02099858762149752,-1,30056584784,4597.12,3905.95,-0.1503484790478,2017-09-20,0.0,0.0047393367,0.99526066,0.2291232,211,-89.63063364880054,-45.71412863185336,-43.91650501694718
184,2017-09-21,3901.47,3916.42,3613.63,3631.04,3631.04,1411480064,BTC,4102.073810,3246.9579995163867,4957.189620483613,0.22457893759816847,50.3027828337702500000,3925.323333,-0.07497046944540199,-1,28645104720,4599.88,3631.04,-0.2106228858144,2017-09-21,0.0,0.006756757,0.9932432,0.1242973,148,-105.79952020758219,-57.731206946999144,-48.06831326058305
185,2017-09-22,3628.02,3758.27,3553.53,3630.70,3630.70,1194829952,BTC,4042.011429,3244.696930416519,4839.325927583481,0.24206449918398495,45.6300677586972500000,3860.711333,-0.05957744911771677,1,29839934672,4228.75,3630.70,-0.1414247709134,2017-09-22,0.009345794,0.0,0.99065423,0.000486,107,-117.28888102204019,-69.64274176200736,-47.646139260032825
186,2017-09-23,3629.92,3819.21,3594.58,3792.40,3792.40,928113984,BTC,4004.565238,3239.9344004419254,4769.196075558075,0.36126296012493364,47.1855341703927500000,3831.621333,-0.01023622367435023,1,30768048656,4226.06,3792.40,-0.1026156751206,2017-09-23,0.028037382,0.0,0.97196263,-0.0016822,107,-112.05475282068801,-78.12514397374349,-33.92960884694452
187,2017-09-24,3796.15,3796.15,3666.90,3682.84,3682.84,768014976,BTC,3961.702381,3233.185188068913,4690.219573931087,0.30860960887001443,47.3061923318852500000,3795.406667,-0.02965865765551178,-1,30000033680,4122.94,3682.84,-0.1067442165057,2017-09-24,0.0,0.008,0.992,0.02908,125,-115.41678764894732,-85.58347270878427,-29.83331494016305
188,2017-09-25,3681.58,3950.25,3681.58,3926.07,3926.07,1374210048,BTC,3946.929048,3229.2991231528063,4664.558972847193,0.48546670973591216,58.2258702981580000000,3782.282000,0.03801620291665190,1,31374243728,4161.27,3926.07,-0.0565212062664,2017-09-25,0.0,0.0,1.0,0.067188,117,-97.3326150999228,-87.93330118701199,-9.399313912910813
189,2017-09-26,3928.41,3969.89,3869.90,3892.35,3892.35,1043740032,BTC,3923.872857,3233.623323421226,4614.122390578774,0.4771656078950451,66.0405819990572500000,3764.354000,0.03400211563524578,-1,30330503696,4130.81,3892.35,-0.0577271769943,2017-09-26,0.0,0.0,1.0,0.1762684,190,-84.74481366983855,-87.29560368357731,2.5507900137387622
190,2017-09-27,3892.94,4210.05,3884.82,4200.67,4200.67,1686880000,BTC,3904.994286,3272.8404081641856,4537.148163835815,0.7338637192357729,76.1623248639357500000,3769.011333,0.11452835474931165,1,32017383696,3882.59,4200.67,0.0819246945982,2017-09-27,0.0060975607,0.0,0.99390244,0.0939573,164,-49.32150500820353,-79.70078394850256,30.37927894029903
191,2017-09-28,4197.13,4279.31,4109.70,4174.73,4174.73,1712320000,BTC,3884.749048,3322.721190508762,4446.776905491238,0.7579773832692275,87.4278107801920000000,3788.487333,0.10195168494707489,-1,30305063696,3154.95,4174.73,0.3232317469374,2017-09-28,0.007246377,0.0,0.9927536,0.156058,138,-23.075419178438096,-68.37571099448967,45.30029181605157
192,2017-09-29,4171.62,4214.63,4039.29,4163.07,4163.07,1367049984,BTC,3881.621429,3326.9508892636363,4436.291968736363,0.75370787777351,91.7493299353495000000,3855.695333,0.07971964599206055,-1,28938013712,3637.52,4163.07,0.1444803052629,2017-09-29,0.010362694,0.005181347,0.98445594,0.2722228,193,-3.179420998230853,-55.3364529952379,52.157031997007046
193,2017-09-30,4166.11,4358.43,4160.86,4338.71,4338.71,1207449984,BTC,3886.985714,3316.3746758813377,4457.596752118662,0.8958250505364928,97.8583004844037500000,3902.441333,0.11179377978364601,1,30145463696,3625.04,4338.71,0.1968723103745,2017-09-30,0.0070921984,0.0,0.9929078,0.1307092,141,26.45600824641633,-38.97796074690705,65.43396899332339
194,2017-10-01,4341.05,4403.74,4269.81,4403.74,4403.74,1208210048,BTC,3900.357143,3294.454402648288,4506.259883351712,0.9153990595155568,97.8583004844037500000,3954.354667,0.11364315314208512,1,31353673744,3582.88,4403.74,0.2291061938999,2017-10-01,0.0,0.0,1.0,0.1671405,185,54.5607332066711,-20.270221956191417,74.83095516286252
195,2017-10-02,4395.81,4470.23,4377.46,4409.32,4409.32,1431730048,BTC,3912.169048,3275.9885104509567,4548.349585549044,0.8907310288957668,98.4784473688470000000,4009.450667,0.09973170047736118,1,32785403792,4065.20,4409.32,0.0846502017121,2017-10-02,0.028409092,0.0,0.97159094,0.1596705,176,76.40345786432817,-0.9354859920874933,77.33894385641567
196,2017-10-03,4408.46,4432.47,4258.89,4317.48,4317.48,1288019968,BTC,3921.058095,3267.0791709781615,4575.037019021838,0.8030846182030493,97.0511931365750000000,4026.269333,0.07232766685854495,-1,31497383824,3924.97,4317.48,0.1000033121272,2017-10-03,0.005586592,0.0,0.99441344,0.1662179,179,85.31974287865387,16.315559782060784,69.00418309659308
197,2017-10-04,4319.37,4352.31,4210.42,4229.36,4229.36,1116770048,BTC,3937.570952,3270.2949563308994,4604.846947669101,0.7186419486792812,91.2730214995762500000,4046.562000,0.04517365605667231,-1,30380613776,3905.95,4229.36,0.0827993189877,2017-10-04,0.0,0.0,1.0,0.1905333,180,84.3036173517844,29.91317129600551,54.39044605577889
198,2017-10-05,4229.88,4362.64,4164.05,4328.41,4328.41,1161769984,BTC,3993.450000,3410.1877861030257,4576.712213896974,0.7871435796963577,88.6751560453110000000,4074.726000,0.06225792850856720,1,31542383760,3631.04,4328.41,0.1920579227990,2017-10-05,0.025423728,0.0,0.9745763,0.172322,118,90.44820545800576,42.02017812840557,48.42802732960019
199,2017-10-06,4324.46,4413.27,4320.53,4370.81,4370.81,1069939968,BTC,4028.368571,3446.804642225675,4609.932499774325,0.7944142613192265,87.4386735506410000000,4124.044000,0.05983592803568536,1,32612323728,3630.70,4370.81,0.2038477428595,2017-10-06,0.0,0.02238806,0.97761196,0.0343955,134,97.61392814748979,53.13892813222241,44.475000015267376
200,2017-10-07,4369.35,4443.88,4321.05,4426.89,4426.89,906928000,BTC,4066.551905,3490.945945523587,4642.157864476412,0.8130076131662834,90.3874804140660000000,4177.123333,0.05979394120992309,1,33519251728,3792.40,4426.89,0.1673056639595,2017-10-07,0.066779174,0.012054002,0.918756,0.1736321,4148,106.58930630172108,63.82900376612215,42.76030253559893
201,2017-10-08,4429.67,4624.14,4405.64,4610.48,4610.48,1313869952,BTC,4115.485238,3537.8614034980283,4693.109072501972,0.928475014735831,96.1656520510647500000,4231.662000,0.08951990967142461,1,34833121680,3682.84,4610.48,0.2518816999924,2017-10-08,0.05816621,0.011174425,0.92969733,0.1666889,13513,127.05195845202252,76.47359470330224,50.57836374872028
202,2017-10-09,4614.52,4878.71,4564.25,4772.02,4772.02,1968739968,BTC,4149.143333,3505.25428285756,4793.03238314244,0.9836832268402518,98.7635175053300000000,4304.274000,0.10867012648358353,1,36801861648,3926.07,4772.02,0.2154699228491,2017-10-09,0.040060014,0.010852713,0.9476369,0.1245483,19995,154.52244504660302,92.08336477196241,62.43908027464062
203,2017-10-10,4776.21,4922.17,4765.10,4781.99,4781.99,1597139968,BTC,4189.953810,3498.8342298555453,4881.073390144455,0.9283167537202861,100.0000000000000000000,4361.335333,0.09645088829036389,1,38399001616,3892.35,4781.99,0.2285611520033,2017-10-10,0.03561629,0.012966052,0.949427,0.0617971,18587,175.07929395210067,108.68255060799008,66.39674334411059
204,2017-10-11,4789.25,4873.73,4751.63,4826.48,4826.48,1222279936,BTC,4233.788571,3502.70887845518,4964.86826354482,0.9053535032117332,100.0000000000000000000,4423.610667,0.09107251142271468,1,39621281552,4200.67,4826.48,0.1489786153161,2017-10-11,0.043583352,0.010499283,0.9446333,0.1785584,13239,192.73894092065893,125.49382867052387,67.24511225013507
205,2017-10-12,4829.58,5446.91,4822.00,5446.91,5446.91,2791610112,BTC,4320.258571,3468.938764410592,5171.578377589409,1.1617086905998555,100.0000000000000000000,4506.693333,0.20862672419161919,1,42412891664,4174.73,5446.91,0.3047334797699,2017-10-12,0.015151516,0.005050505,0.97979796,0.0681313,198,253.87137690090003,151.16933831659912,102.70203858430091
206,2017-10-13,5464.16,5840.30,5436.85,5647.21,5647.21,3615480064,BTC,4416.282857,3445.159568902286,5387.406145097714,1.1337646095436569,100.0000000000000000000,4604.858667,0.22635902823030117,1,46028371728,4163.07,5647.21,0.3565013319497,2017-10-13,0.012987013,0.032467533,0.95454544,0.0814221,154,314.8523846384951,183.90594758097834,130.94643705751676
207,2017-10-14,5643.53,5837.70,5591.64,5831.79,5831.79,1669030016,BTC,4513.396667,3405.9870839218456,5620.806250078154,1.0952600343837533,100.0000000000000000000,4716.106667,0.23656872326632641,1,47697401744,4338.71,5831.79,0.3441299372394,2017-10-14,0.0,0.0,1.0,0.3348283,233,373.76579492194924,221.87791704917254,151.8878778727767
208,2017-10-15,5835.96,5852.48,5478.61,5678.19,5678.19,1976039936,BTC,4608.413333,3458.7083664571337,5758.118299542867,0.9652396476188104,97.6036394725510000000,4805.405333,0.18162560835531499,-1,45721361808,4403.74,5678.19,0.2894017357973,2017-10-15,0.0,0.005988024,0.994012,0.1537904,167,403.41059554139156,258.1844527476163,145.22614279377524
209,2017-10-16,5687.57,5776.23,5544.21,5725.59,5725.59,2008070016,BTC,4694.104762,3490.992515289511,5897.217008710489,0.9286737338183758,95.9467808266195000000,4893.528667,0.17003299451602048,1,47729431824,4409.32,5725.59,0.2985199531901,2017-10-16,0.0,0.0,1.0,0.1141974,152,425.8205033401664,291.71166286612635,134.10884047404005
210,2017-10-17,5741.58,5800.35,5472.72,5605.51,5605.51,1821570048,BTC,4775.683810,3568.5809776368887,5982.786642363112,0.8437263867467993,92.4165174141772500000,4973.274667,0.12712656656491882,-1,45907861776,4317.48,5605.51,0.2983291179114,2017-10-17,0.0045045046,0.0045045046,0.990991,0.2249414,222,428.9464374670597,319.158617786313,109.78781968074668
211,2017-10-18,5603.82,5603.82,5151.44,5590.69,5590.69,2399269888,BTC,4841.875238,3614.9218534475303,6068.828622552469,0.8051520829673288,88.6550426539692500000,5058.155333,0.10528238694562843,-1,43508591888,4229.36,5590.69,0.3218761231014,2017-10-18,0.0,0.0,1.0,0.2064405,168,425.32503047125465,340.3919003233014,84.93313014795325
212,2017-10-19,5583.74,5744.35,5531.06,5708.52,5708.52,1780540032,BTC,4914.912857,3672.2512744097467,6157.574439590254,0.8193174851940678,89.0015222464582500000,5156.766000,0.10699612896920279,1,45289131920,4328.41,5708.52,0.3188491848046,2017-10-19,0.0,0.0,1.0,0.0670973,113,427.0402803368297,357.7215763260071,69.31870401082261
213,2017-10-20,5708.11,6060.11,5627.23,6011.45,6011.45,2354429952,BTC,5002.930952,3722.6595603661044,6283.202343633895,0.8938692431113836,90.6583808923897500000,5268.968667,0.14091587555838468,1,47643561872,4370.81,6011.45,0.3753629190013,2017-10-20,0.031007752,0.0,0.96899223,0.1064419,129,447.68293566141165,375.71384819308804,71.96908746832361
214,2017-10-21,5996.79,6194.88,5965.07,6031.60,6031.60,2207099904,BTC,5083.544762,3766.276801019867,6400.812722980134,0.8598566374052645,94.1886443048320000000,5379.688000,0.12118026175495679,1,49850661776,4426.89,6031.60,0.3624915008053,2017-10-21,0.0057803467,0.011560693,0.982659,0.1211156,173,460.36156362533893,392.64339127953826,67.71817234580067
215,2017-10-22,6036.66,6076.26,5792.34,6008.42,6008.42,2034630016,BTC,5159.958095,3822.3022985318785,6497.613891468121,0.8171450784425395,97.5423421003925000000,5485.123333,0.09540289893787881,-1,47816031760,4610.48,6008.42,0.3032092103208,2017-10-22,0.0,0.0,1.0,0.0312117,137,463.19955921669134,406.7546248669689,56.444934349722416
216,2017-10-23,6006.00,6075.59,5732.47,5930.32,5930.32,2401840128,BTC,5232.386667,3900.73722316978,6564.0361108302195,0.7620559548286733,97.5820291612040000000,5573.112667,0.06409476253999442,-1,45414191632,4772.02,5930.32,0.2427273984602,2017-10-23,0.008333334,0.008333334,0.975,0.0414583,120,453.91423342743565,416.18654657906234,37.72768684837331
217,2017-10-24,5935.52,5935.52,5504.18,5526.64,5526.64,2735699968,BTC,5289.965714,4021.3948850342476,6558.536542965752,0.5932838279881296,87.4796772274007500000,5623.420667,-0.01721028404791756,-1,42678491664,4781.99,5526.64,0.1557196899199,2017-10-24,0.017857144,0.0,0.98214287,0.0203393,112,409.26420210098513,414.80207768344695,-5.537875582461822
218,2017-10-25,5524.60,5754.33,5397.88,5750.80,5750.80,1966989952,BTC,5362.415238,4177.205054553722,6547.625421446277,0.6638463655748723,81.6545311838532500000,5688.008000,0.01103936562677127,1,44645481616,4826.48,5750.80,0.1915101689016,2017-10-25,0.015873017,0.0,0.96825397,0.0371508,126,387.49971290723715,409.341604728205,-21.841891820967874
219,2017-10-26,5747.95,5976.80,5721.22,5904.83,5904.83,1905040000,BTC,5437.482857,4330.204685967212,6544.761028032788,0.711034207675246,76.6419144355930000000,5759.898000,0.02516225113708611,1,46550521616,5446.91,5904.83,0.0840696835453,2017-10-26,0.0,0.039473683,0.9605263,0.0742632,152,378.3191044608993,403.13710467474397,-24.81800021384464
220,2017-10-27,5899.74,5988.39,5728.82,5780.90,5780.90,1710130048,BTC,5504.630000,4503.052686419067,6506.207313580933,0.6379174609158493,66.2402341018835000000,5782.164000,-0.00021860327725052,-1,44840391568,5647.21,5780.90,0.0236736370703,2017-10-27,0.0,0.0,1.0,0.0504412,68,356.92883774734673,393.89545128926454,-36.96661354191781
221,2017-10-28,5787.82,5876.72,5689.19,5753.09,5753.09,1403920000,BTC,5567.782381,4692.312021503923,6443.252740496077,0.6058331769830926,62.5538700977907500000,5789.222667,-0.00624136763748355,-1,43436471568,5831.79,5753.09,-0.0134949989626,2017-10-28,0.085365854,0.0,0.91463417,0.0713537,82,333.8840551968042,381.8931720707725,-48.00911687396831
222,2017-10-29,5754.44,6255.71,5724.58,6153.85,6153.85,2859040000,BTC,5641.276190,4848.0724309953885,6434.479949004611,0.8231034927540106,68.3790161413382500000,5810.693333,0.05905606221742076,1,46295511568,5678.19,6153.85,0.0837696519489,2017-10-29,0.03448276,0.0,0.9655172,0.1647172,145,343.99353726704976,374.313245110028,-30.319707842978232
223,2017-10-30,6114.85,6214.99,6040.85,6130.53,6130.53,1772150016,BTC,5705.967143,4992.981774815131,6418.952511184869,0.7977360237285511,72.8698966130667500000,5840.849333,0.04959564105914252,1,48067661584,5725.59,6130.53,0.0707245890816,2017-10-30,0.028571429,0.007142857,0.95714283,0.0955357,140,346.1336325152579,368.677322591074,-22.54369007581613
224,2017-10-31,6132.02,6470.43,6103.33,6468.40,6468.40,2311379968,BTC,5786.272381,5132.990937703016,6439.553824296983,1.0220779083800662,85.2817708209247500000,5890.370000,0.09813135677385292,1,50379041552,5605.51,6468.40,0.1539360379341,2017-10-31,0.011111111,0.027777778,0.9611111,0.1800722,180,370.8183943146141,369.1055369357821,1.712857378832041
225,2017-11-01,6440.97,6767.31,6377.88,6767.31,6767.31,2870320128,BTC,5878.692857,5246.910587000505,6510.475126999495,1.2032621721093177,99.0704867588207500000,5967.823333,0.13396620884856211,1,53249361680,5590.69,6767.31,0.2104606050416,2017-11-01,0.014705882,0.11764706,0.86764705,0.0044044,136,409.7771284794235,377.2398552445104,32.53727323491307
226,2017-11-02,6777.77,7367.33,6758.72,7078.50,7078.50,4653770240,BTC,5956.387619,5166.187779569373,6746.5874584306275,1.210018102388207,99.0704867588207500000,6067.010667,0.16671955737637736,1,57903131920,5708.52,7078.50,0.2399886485464,2017-11-02,0.017699115,0.022123894,0.9557522,0.1551106,226,460.4548013065114,393.8828444569107,66.57195684960072
227,2017-11-03,7087.53,7461.29,7002.94,7207.76,7207.76,3369860096,BTC,6030.699524,5084.501497803027,6976.897550196973,1.1219947851354788,100.0000000000000000000,6166.960000,0.16877035038333312,1,61272992016,6011.45,7207.76,0.1990052316829,2017-11-03,0.013215859,0.039647575,0.9471366,0.1738194,227,505.2235213378335,416.1509798330953,89.07254150473824
228,2017-11-04,7164.48,7492.86,7031.28,7379.95,7379.95,2483800064,BTC,6104.421429,4995.978190159405,7212.864667840595,1.075369367733332,100.0000000000000000000,6258.193333,0.17924608705916436,1,63756792080,6031.60,7379.95,0.2235476490483,2017-11-04,0.0,0.0124223605,0.9875776,0.1491677,161,548.2771504371722,442.57621395391067,105.7009364832615
229,2017-11-05,7404.52,7617.48,7333.19,7407.41,7407.41,2380410112,BTC,6186.765238,4960.637390430767,7412.893085569233,0.9977640644977995,100.0000000000000000000,6349.914000,0.16653705861213238,1,66137202192,6008.42,7407.41,0.2328382503220,2017-11-05,0.004048583,0.008097166,0.98785424,0.2210324,247,577.9509948136429,469.65117012585716,108.2998246877857
230,2017-11-06,7403.22,7445.77,7007.31,7022.76,7022.76,3111899904,BTC,6248.535238,4989.72421614455,7507.346259855451,0.8075222366812516,94.8870675308517500000,6417.536667,0.09430773276484031,-1,63025302288,5930.32,7022.76,0.1842126563153,2017-11-06,0.0,0.004651163,0.9953488,0.1535674,215,563.9290671951612,488.506749539718,75.42231765544324
231,2017-11-07,7023.10,7253.32,7023.10,7144.38,7144.38,2326340096,BTC,6321.814762,5041.24343141948,7602.38609258052,0.8211711906852964,91.3907601673782500000,6498.474000,0.09939348837896405,1,65351642384,5526.64,7144.38,0.2927167320470,2017-11-07,0.03846154,0.028846154,0.9326923,0.0007788,104,556.2185645605987,502.0491125438942,54.1694520167045
232,2017-11-08,7141.38,7776.42,7114.02,7459.69,7459.69,4602200064,BTC,6410.814762,5084.6782453831165,7736.951278616883,0.8954627690502758,91.3907601673782500000,6627.344000,0.12559269595783771,1,69953842448,5750.80,7459.69,0.2971569172985,2017-11-08,0.01438849,0.0,0.9856115,0.0942446,139,568.9918334452914,515.4376567241736,53.554176721117756
233,2017-11-09,7446.83,7446.83,7101.52,7143.58,7143.58,3226249984,BTC,6479.150952,5157.118370587504,7801.183533412496,0.7512907235955204,86.7600617025945000000,6720.196000,0.06300173387799999,-1,66727592464,5904.83,7143.58,0.2097858871466,2017-11-09,0.014925373,0.0,0.9701493,0.0775,134,547.2983910741532,521.8098035941696,25.488587479983607
234,2017-11-10,7173.73,7312.00,6436.87,6618.14,6618.14,5208249856,BTC,6508.040952,5202.522110161173,7813.559793838827,0.5421667786291484,79.5451200360342500000,6767.750000,-0.02210631302870230,-1,61519342608,5780.90,6618.14,0.1448286598972,2017-11-10,0.021582734,0.0,0.9784173,0.0959353,139,482.14964455268364,513.8777717858724,-31.72812723318873
235,2017-11-11,6618.61,6873.15,6204.22,6357.60,6357.60,4908680192,BTC,6523.564762,5234.18716260378,7812.94236139622,0.43564152111929183,66.8969002695417500000,6806.196667,-0.06591003594930355,-1,56610662416,5753.09,6357.60,0.1050757071417,2017-11-11,0.0069444445,0.0,0.9722222,-0.0012639,144,404.8287790685881,492.0679732424155,-87.2391941738274
236,2017-11-12,6295.45,6625.05,5519.01,5950.07,5950.07,8957349888,BTC,6520.786190,5226.503921273797,7815.068458726203,0.27952406372619043,41.8969002695417500000,6819.328667,-0.12746983016180235,-1,47653312528,6153.85,5950.07,-0.0331142293036,2017-11-12,0.018691588,0.0,0.9813084,0.137514,107,307.12680471735894,455.0797395374042,-147.95293482004524
237,2017-11-13,5938.25,6811.19,5844.29,6559.49,6559.49,6263249920,BTC,6550.746667,5285.058681304736,7816.434652695265,0.5034539843542865,31.6198736114470000000,6846.371333,-0.04190268377895476,1,53916562448,6130.53,6559.49,0.0699711117962,2017-11-13,0.0,0.0,0.9927536,0.0482246,138,275.694353607053,419.202662351334,-143.508308744281
238,2017-11-14,6561.48,6764.98,6461.75,6635.75,6635.75,3197110016,BTC,6603.561429,5428.003339660547,7779.119518339454,0.5136907615590849,30.3029232217782500000,6880.052667,-0.03550883675233936,1,57113672464,6468.40,6635.75,0.0258719312349,2017-11-14,0.011049724,0.0,0.98342544,0.1773646,181,254.00939209488115,386.1640083000435,-132.15461620516237
239,2017-11-15,6634.76,7342.25,6634.76,7315.54,7315.54,4200880128,BTC,6678.072857,5531.529833260501,7824.6158807394995,0.777995299697029,44.0602601979307500000,6936.528667,0.05463991445795030,1,61314552592,6767.31,7315.54,0.0810115097432,2017-11-15,0.011494253,0.0,0.9885057,0.1605057,174,288.3533175845296,366.6018701569408,-78.2485525724112
240,2017-11-16,7323.24,7967.38,7176.58,7871.69,7871.69,5123809792,BTC,6771.732857,5570.449727473195,7973.015986526805,0.9578259346043099,69.0602601979307500000,7010.154000,0.12289829866790373,1,66438362384,7078.50,7871.69,0.1120562266017,2017-11-16,0.003984064,0.0,0.99601597,0.2089004,251,356.34011561702664,364.549519248958,-8.209403631931366
241,2017-11-17,7853.57,8004.59,7561.09,7708.99,7708.99,4651670016,BTC,6863.546667,5685.830088236954,8041.263245763045,0.8589332731852889,81.8512817061507500000,7052.186667,0.09313470615765821,-1,61786692368,7207.76,7708.99,0.0695403287568,2017-11-17,0.0,0.0,1.0,0.0878462,169,392.56635216221275,370.152885831609,22.41346633060374
242,2017-11-18,7697.21,7884.99,7463.44,7790.15,7790.15,3667190016,BTC,6960.549524,5832.457259325232,8088.641788674768,0.8677006314014465,94.4352825515080000000,7091.012667,0.09859485038767877,1,65453882384,7379.95,7790.15,0.0555830324054,2017-11-18,0.009345794,0.0,0.99065423,0.0839346,107,422.9493425400942,380.7121771733061,42.23716536678813
243,2017-11-19,7766.03,8101.91,7694.10,8036.49,8036.49,3149319936,BTC,7050.199048,5892.523204321733,8207.874891678268,0.925978894431394,96.8224727053215000000,7134.782000,0.12638199737567315,1,68603202320,7407.41,8036.49,0.0849257702760,2017-11-19,0.0,0.005181347,0.9948186,0.0417358,193,461.58479819956665,396.88670137855826,64.69809682100839
244,2017-11-20,8039.07,8336.86,7949.36,8200.64,8200.64,3488450048,BTC,7148.775714,5967.69777588463,8329.853652115371,0.9452984227605014,96.8224727053215000000,7187.664000,0.14093257559062305,1,72091652368,7022.76,8200.64,0.1677232313222,2017-11-20,0.0060975607,0.0,0.98170733,0.1162927,164,499.6891032801432,417.44718175887533,82.24192152126784
245,2017-11-21,8205.74,8348.66,7762.71,8071.26,8071.26,4277609984,BTC,7225.102381,6021.7362136692955,8428.468548330704,0.8515794452144768,97.5019848529295000000,7257.564000,0.11211695825210773,-1,67814042384,7144.38,8071.26,0.1297355403828,2017-11-21,0.01,0.0,0.99,0.14293,200,513.5275292107071,436.66325124924174,76.8642779614654
246,2017-11-22,8077.95,8302.26,8075.47,8253.55,8253.55,3633530112,BTC,7295.875714,6032.278060827577,8559.473367172423,0.878947477306418,98.5628085329495000000,7331.508667,0.12576420145968300,1,71447572496,7459.69,8253.55,0.1064199718755,2017-11-22,0.0,0.0,0.98571426,0.1179929,140,533.0590875747312,455.9424185143396,77.11666906039159
247,2017-11-23,8232.38,8267.40,8038.77,8038.77,8038.77,4225179904,BTC,7341.602857,6042.054900160501,8641.150813839498,0.7682344808172803,96.2317702777877500000,7370.114000,0.09072532663673859,-1,67222392592,7143.58,8038.77,0.1253139182315,2017-11-23,0.0,0.0,1.0,0.0551324,136,525.1533959123772,469.78461399394706,55.3687819184301
248,2017-11-24,8074.02,8374.16,7940.93,8253.69,8253.69,5058610176,BTC,7391.409048,6034.499344476515,8748.318751523486,0.8177370423989586,96.2317702777877500000,7444.121333,0.10875275009438109,1,72281002768,6618.14,8253.69,0.2471313692367,2017-11-24,0.00729927,0.0,0.99270076,0.0611387,137,530.1194391637282,481.8515790279033,48.26786013582489
249,2017-11-25,8241.71,8790.92,8191.15,8790.92,8790.92,4342060032,BTC,7458.598095,5970.665463250579,8946.530726749423,0.9477090819069998,97.6689617448382500000,7588.973333,0.15838066814300664,1,76623062800,6357.60,8790.92,0.3827419151881,2017-11-25,0.020547945,0.0,0.9726027,0.1256027,146,570.8249208572706,499.6462473937769,71.17867346349374
250,2017-11-26,8789.04,9522.93,8775.59,9330.55,9330.55,5475579904,BTC,7550.176190,5853.4037363283105,9246.94864367169,1.0246354059282967,97.6689617448382500000,7787.170000,0.19819523652366649,1,82098642704,5950.07,9330.55,0.5681412151454,2017-11-26,0.00990099,0.004950495,0.9851485,0.2922129,202,639.2589599543944,527.5687899059005,111.69017004849388
251,2017-11-27,9352.72,9818.35,9352.72,9818.35,9818.35,5653320192,BTC,7683.299524,5739.618987981015,9626.980060018985,1.049228753500042,100.0000000000000000000,8045.055333,0.22042044381299969,1,87751962896,6559.49,9818.35,0.4968160634440,2017-11-27,0.010309278,0.0,0.9896907,0.1455258,194,724.5031903294857,566.9556699906176,157.54752033886814
252,2017-11-28,9823.43,10125.70,9736.30,10058.80,10058.80,6348819968,BTC,7822.081429,5638.617683898785,10005.545174101215,1.012195033239793,100.0000000000000000000,8278.342667,0.21507412831525400,1,94100782864,6635.75,10058.80,0.5158497532306,2017-11-28,0.024734983,0.003533569,0.9681979,0.1687597,283,802.2147304076525,614.0074820740247,188.20724833362783
253,2017-11-29,10077.40,11517.40,9601.03,9888.61,9888.61,11568799744,BTC,7937.744286,5584.200294785291,10291.28827721471,0.9144527829694657,98.4490168631482500000,8495.200000,0.16402321310857896,-1,82531983120,7315.54,9888.61,0.3517265984466,2017-11-29,0.01607717,0.0,0.977492,0.1417363,311,840.3813817232776,659.2822620038753,181.09911971940232
254,2017-11-30,9906.79,10801.00,9202.05,10233.60,10233.60,8310689792,BTC,8084.888095,5559.75737257299,10610.018817427012,0.9254654790574132,98.4490168631482500000,8689.737333,0.17766505566710897,1,90842672912,7871.69,10233.60,0.3000511961218,2017-11-30,0.003921569,0.0,0.99215686,0.1215647,255,888.2276026808204,705.0713301392644,183.15627254155595
255,2017-12-01,10198.60,11046.70,9694.65,10975.60,10975.60,6783119872,BTC,8292.386190,5565.405202970744,11019.367177029255,0.9919751591159911,98.4490168631482500000,8896.664667,0.23367581119599818,1,97625792784,7708.99,10975.60,0.4237403343369,2017-12-01,0.01010101,0.0,0.989899,0.1352778,198,974.7825892822384,759.0135819678593,215.7690073143791
256,2017-12-02,10978.30,11320.20,10905.10,11074.60,11074.60,5138500096,BTC,8517.005238,5684.341666393804,11349.668809606195,0.9514469680827251,98.4490168631482500000,9121.038667,0.21418189356745109,1,102764292880,7790.15,11074.60,0.4216157583615,2017-12-02,0.042424243,0.0,0.95757574,0.1128303,165,1039.3851275995712,815.0878910942018,224.29723650536937
257,2017-12-03,11082.70,11858.70,10862.00,11323.20,11323.20,6608309760,BTC,8772.868571,5943.356241199788,11602.380900800214,0.9506662512370241,100.0000000000000000000,9356.575333,0.21018637663973586,1,109372602640,8036.49,11323.20,0.4089733204421,2017-12-03,0.029411765,0.022058824,0.9485294,0.1162647,136,1097.9861461450728,871.667542104376,226.31860404069675
258,2017-12-04,11315.40,11657.20,11081.80,11657.20,11657.20,6132409856,BTC,9015.616667,6109.982009329953,11921.251324670047,0.9545621945324361,100.0000000000000000000,9597.956000,0.21455026466051730,1,115505012496,8200.64,11657.20,0.4214988098490,2017-12-04,0.042105265,0.0,0.95789474,0.1635526,190,1158.0298370122946,928.9400010859597,229.0898359263349
259,2017-12-05,11685.70,12032.00,11604.60,11916.70,11916.70,6895260160,BTC,9267.090476,6312.837190965176,12221.343761034823,0.9484398032866652,100.0000000000000000000,9845.693333,0.21034645270319024,1,122400272656,8071.26,11916.70,0.4764361450381,2017-12-05,0.009569378,0.004784689,0.98564595,0.1451196,209,1212.576548194138,985.6673105075955,226.9092376865425
260,2017-12-06,11923.40,14369.10,11923.40,14291.50,14291.50,12656300032,BTC,9599.279048,6056.487211727907,13142.070884272092,1.1622208090184316,100.0000000000000000000,10260.376000,0.39288267798373081,1,135056572688,8253.55,14291.50,0.7315579356762,2017-12-06,0.010416667,0.0069444445,0.9826389,0.1133229,288,1430.93677401698,1074.7212032094726,356.21557080750745
261,2017-12-07,14266.10,17899.70,14057.30,17899.70,17899.70,17950699520,BTC,10076.803333,5099.240159464846,15054.366506535152,1.2858159097400308,100.0000000000000000000,10903.452667,0.64165430406962668,1,153007272208,8038.77,17899.70,1.2266714932757,2017-12-07,0.020050125,0.010025063,0.9699248,0.1155288,399,1873.54336899782,1234.4856363671422,639.0577326306777
262,2017-12-08,17802.90,18353.40,14336.90,16569.40,16569.40,21135998976,BTC,10498.727619,4900.700733269975,16096.754504730023,1.0422153648881898,96.5522013765277500000,11472.161333,0.44431371901453715,-1,131871273232,8253.69,16569.40,1.0075142148542,2017-12-08,0.023879673,0.009115621,0.96514904,0.1309714,61433,2092.84319861477,1406.1571488166678,686.686049798102
263,2017-12-09,16523.30,16783.00,13674.90,15178.20,15178.20,13911300096,BTC,10850.539524,5042.7621493153365,16658.316898684665,0.8725745837696621,89.0827598047695000000,11933.795333,0.27186696071688026,-1,117959973136,8790.92,15178.20,0.7265769680534,2017-12-09,0.025308045,0.009543368,0.9633365,0.1405799,33112,2129.8303222656687,1550.891783506468,578.9385387592006
264,2017-12-10,15168.40,15850.60,13226.60,15455.40,15455.40,13433299968,BTC,11203.820952,5215.226921194757,17192.414982805243,0.8549730559568688,81.9516557862845000000,12378.094000,0.24860903463812765,1,131393273104,9330.55,15455.40,0.6564296852811,2017-12-10,0.008,0.0,0.992,0.165036,250,2156.6500878011684,1672.0434443654083,484.60664343576013
265,2017-12-11,15427.40,17513.90,15404.80,16936.80,16936.80,12153900032,BTC,11619.828571,5302.709985197497,17936.947156802504,0.9208383424168815,78.9728836751892500000,12885.177333,0.31444058256175185,1,143547173136,9818.35,16936.80,0.7250148955782,2017-12-11,0.0066225166,0.0,0.9933775,0.1981192,302,2271.2598744670577,1791.8867303857382,479.3731440813194
266,2017-12-12,16919.80,17781.80,16571.60,17415.40,17415.40,14603799552,BTC,12064.787619,5486.51298536268,18643.06225263732,0.9066881271298863,80.9093398970657500000,13391.647333,0.30046734109287494,1,158150972688,10058.80,17415.40,0.7313596055195,2017-12-12,0.025547445,0.0,0.97445256,0.1895803,274,2373.3494807871157,1908.1792804660138,465.1702003211019
267,2017-12-13,17500.00,17653.10,16039.70,16408.20,16408.20,12976900096,BTC,12453.104286,5857.020626825955,19049.187945174046,0.7998063637730797,83.7242962489600000000,13814.940667,0.18771411296717081,-1,145174072592,9888.61,16408.20,0.6593029758480,2017-12-13,0.049792532,0.0,0.9502075,0.1795975,241,2345.9410586839276,1995.7316361095968,350.2094225743308
268,2017-12-14,16384.60,17085.80,16185.90,16564.00,16564.00,13777399808,BTC,12859.067619,6355.318180505601,19362.817057494398,0.7848304978564552,86.4995348339130000000,14259.966667,0.16157354268800129,1,158951472400,10233.60,16564.00,0.6185897435897,2017-12-14,0.040816326,0.0040816325,0.955102,0.1935918,245,2310.1613426765052,2058.6175774229787,251.54376525352654
269,2017-12-15,16601.30,18154.10,16601.30,17706.90,17706.90,14309999616,BTC,13309.220476,6835.730380499812,19782.71057150019,0.8396683596578675,88.7821875937567500000,14758.186667,0.19980187265102574,1,173261472016,10975.60,17706.90,0.6132967673749,2017-12-15,0.008547009,0.0,0.991453,0.0946368,234,2346.973686545316,2116.288799247446,230.68488729786986
270,2017-12-16,17760.30,19716.70,17515.30,19497.40,19497.40,12740599808,BTC,13819.052857,7156.464973625722,20481.640740374278,0.9261367536456565,90.2935299953525000000,15326.306667,0.27215254292027406,1,186002071824,11074.60,19497.40,0.7605511711484,2017-12-16,0.011173184,0.011173184,0.9776536,0.0950615,179,2491.9010363334655,2191.41124666465,300.4897896688153
271,2017-12-17,19475.80,20089.00,18974.10,19140.80,19140.80,13314599936,BTC,14286.207619,7569.931623042405,21002.483614957597,0.8614050691128453,93.8573886095547500000,15864.053333,0.20655166735879506,-1,172687471888,11323.20,19140.80,0.6904055390702,2017-12-17,0.037383176,0.0,0.95327103,0.2108364,214,2548.6036490181014,2262.8497271353403,285.753921882761
272,2017-12-18,19106.40,19371.00,18355.90,19114.20,19114.20,14839499776,BTC,14728.867143,8024.02294702604,21433.71133897396,0.8270272006941823,96.9913464386890000000,16383.453333,0.16667711083228438,1,187526971664,11657.20,19114.20,0.6396904917133,2017-12-18,0.029045643,0.004149378,0.9626556,0.1127593,241,2561.86291936403,2322.6523655810784,239.2105537829516
273,2017-12-19,19118.30,19177.80,17275.40,17776.70,17776.70,16894499840,BTC,15096.386190,8624.632776741808,21568.13960325819,0.7070778689210443,92.0128579041252500000,16791.420000,0.05867758652931080,-1,170632471824,11916.70,17776.70,0.4917468762325,2017-12-19,0.018382354,0.0,0.9742647,0.1508051,272,2436.361060933057,2345.394104651474,90.96695628158295
274,2017-12-20,17760.30,17934.70,16077.70,16624.60,16624.60,22149699584,BTC,15417.147619,9376.091088352718,21458.20414964728,0.5999371860596232,78.2169724664487500000,17105.280000,-0.02810126463875482,-1,148482772240,14291.50,16624.60,0.1632508833922,2017-12-20,0.025270758,0.0036101083,0.96750903,0.1059892,277,2218.363182603547,2319.987920241889,-101.62473763834168
275,2017-12-21,16642.40,17567.70,15342.70,15802.90,15802.90,16516599808,BTC,15682.352381,10127.63449199104,21237.07027000896,0.5108509218117562,57.9234307075985000000,17206.040000,-0.08154926990754409,-1,131966172432,17899.70,15802.90,-0.1171416280720,2017-12-21,0.020408163,0.0034013605,0.9727891,0.0174966,294,1956.7379140603298,2247.337919005577,-290.6000049452473
276,2017-12-22,15898.00,15943.40,11833.00,13831.80,13831.80,22197999616,BTC,15818.361905,10619.18870400883,21017.53510599117,0.3089540559428485,34.1453383119962500000,16934.846667,-0.18323441174384741,-1,109768172816,16569.40,13831.80,-0.1652202252345,2017-12-22,0.024647888,0.0035211267,0.9683099,0.1019683,284,1572.2230978850293,2112.3149547814673,-540.091856896438
277,2017-12-23,13948.70,15603.20,13828.80,14699.20,14699.20,13086000128,BTC,15990.961905,11231.116313606854,20750.807496393147,0.3643063225269544,18.6474313714912500000,16810.166667,-0.12557678390804024,1,122854172944,15178.20,14699.20,-0.0315584193119,2017-12-23,0.048780486,0.0,0.9414634,0.121078,205,1322.2422806454306,1954.30041995426,-632.0581393088294
278,2017-12-24,14608.20,14626.00,12747.70,13925.80,13925.80,11572299776,BTC,16114.895238,11746.02824827546,20483.76222772454,0.2494664814528922,7.8581007685012500000,16726.673333,-0.16744951475044150,-1,111281873168,15455.40,13925.80,-0.0989686452631,2017-12-24,0.052083332,0.010416667,0.9322917,0.1148646,192,1049.624349437605,1773.365205850929,-723.7408564133241
279,2017-12-25,13995.90,14593.00,13448.90,14026.60,14026.60,10664699904,BTC,16227.723810,12236.293289044004,20219.154330955993,0.22426880557690337,5.1018426998022500000,16631.420000,-0.15662042086604752,1,121946573072,16936.80,14026.60,-0.1718270275377,2017-12-25,0.07913669,0.0,0.92086333,0.062795,278,832.1142967853812,1585.1150240378195,-753.0007272524383
280,2017-12-26,14036.60,16461.20,14028.90,16099.80,16099.80,13454300160,BTC,16426.919048,12955.441764986874,19898.396331013126,0.4528847488645998,15.1096088675515000000,16575.620000,-0.02870601521994351,1,135400873232,17415.40,16099.80,-0.0755423360933,2017-12-26,0.12807882,0.0,0.8719212,0.0583103,203,817.601129582341,1431.6122451467238,-614.0111155643829
281,2017-12-27,16163.50,16930.90,15114.30,15838.50,15838.50,12487600128,BTC,16500.585714,13156.096731637695,19845.074696362306,0.40101840408331213,20.1368787065800000000,16470.493333,-0.03837124488152088,-1,122913273104,16408.20,15838.50,-0.0347204446557,2017-12-27,0.10204082,0.0040816325,0.8897959,0.0778245,245,776.0685783094541,1300.50351177927,-524.4349334698159
282,2017-12-28,15864.10,15888.40,13937.30,14606.50,14606.50,12336499712,BTC,16343.766667,12966.145131461517,19721.38820253848,0.24282691996114467,23.1405323354985000000,16350.380000,-0.10665684834236269,-1,110576773392,16564.00,14606.50,-0.1181779763342,2017-12-28,0.125,0.0,0.875,0.0866964,224,636.4055415508719,1167.6839177335903,-531.2783761827184
283,2017-12-29,14695.80,15279.00,14307.00,14656.20,14656.20,13025500160,BTC,16252.661905,12798.26455062619,19707.05925937381,0.2689232388134752,25.9187023439707500000,16223.193333,-0.09658969728311996,-1,97551273232,17706.90,14656.20,-0.1722887687850,2017-12-29,0.13716814,0.0044247787,0.8539823,0.0703053,226,523.6951219633938,1038.886158579551,-515.1910366161571
284,2017-12-30,14681.90,14681.90,12350.10,12952.20,12952.20,14452599808,BTC,16146.661905,12427.335895908467,19865.987914091536,0.07055903446061917,15.9109361762215000000,15906.213333,-0.18571442939668261,-1,83098673424,19497.40,12952.20,-0.3356960415235,2017-12-30,0.15555556,0.0,0.84444445,0.0911733,225,293.48957819932,889.8068425035048,-596.3172643041847
285,2017-12-31,12897.70,14377.40,12755.60,14156.40,14156.40,12136299520,BTC,16084.804762,12275.083596100223,19894.525927899776,0.24690998658105848,11.9207708930160000000,15550.146667,-0.08962916536072052,1,95234972944,19140.80,14156.40,-0.2604070885229,2017-12-31,0.09489051,0.0,0.9014599,0.2290365,274,205.84603729791343,753.0146814623865,-547.1686441644731
286,2018-01-01,14112.20,14112.20,13154.70,13657.20,13657.20,10291200000,BTC,15928.633333,11998.618931330037,19858.64773466996,0.2110146298656299,11.3626059435177500000,15184.573333,-0.10058717485861939,-1,84943772944,19114.20,13657.20,-0.2854945537872,2018-01-01,0.08080808,0.0,0.9191919,0.2474343,297,95.01139942406735,621.4140250547227,-526.4026256306554
287,2018-01-02,13625.00,15444.60,13163.60,14982.10,14982.10,16846600192,BTC,15812.761905,11923.582910159992,19701.940899840007,0.3932085787126171,18.2435689699770000000,14909.100000,0.00489633847784239,1,101790373136,17776.70,14982.10,-0.1572057806004,2018-01-02,0.19617225,0.0,0.80382776,0.201488,209,112.78242215603677,519.6877044749856,-406.9052823189488
288,2018-01-03,14978.20,15572.80,14844.50,15201.00,15201.00,16871900160,BTC,15755.276190,11867.375069392758,19643.177310607243,0.42871781292711614,33.5523588621455000000,14737.386667,0.03145831370755334,1,118662273296,16624.60,15201.00,-0.0856321355100,2018-01-03,0.14814815,0.0,0.8518519,0.1365226,243,142.88242660444848,444.3266489008781,-301.44422229642964
289,2018-01-04,15270.70,15739.70,14522.20,15599.20,15599.20,21783199744,BTC,15709.333333,11838.806869412221,19579.859796587778,0.48577282263329224,49.7117238918242500000,14669.026667,0.06341070570773133,1,140445473040,15802.90,15599.20,-0.0128900391700,2018-01-04,0.074235804,0.008733625,0.9170306,0.0818865,229,196.6020035695692,394.78171983461635,-198.17971626504715
290,2018-01-05,15477.20,17705.20,15202.80,17429.50,17429.50,23840899072,BTC,15696.123810,11852.429962199547,19539.817657800453,0.7254831236093272,71.8514512530705000000,14777.466667,0.17946468043283322,1,164286372112,13831.80,17429.50,0.2601035295479,2018-01-05,0.04366812,0.0,0.9475983,0.1353013,229,382.45635012836465,392.31664589336606,-9.86029576500141
291,2018-01-06,17462.10,17712.40,16764.60,17527.00,17527.00,18314600448,BTC,15602.295238,12064.28904497196,19140.30143102804,0.7720041538922124,86.3327446513500000000,15023.813333,0.16661460120126214,1,182600972560,14699.20,17527.00,0.1923778164798,2018-01-06,0.016666668,0.0,0.9722222,0.0844333,180,531.4880307624571,420.1509228671843,111.33710789527282
292,2018-01-07,17527.30,17579.60,16087.70,16477.60,16477.60,15866000384,BTC,15475.476190,12297.588932777202,18653.363447222797,0.6576713912242076,90.2892778334142500000,15142.373333,0.08817816320048857,-1,166734972176,13925.80,16477.60,0.1832426144279,2018-01-07,0.022988506,0.0,0.9655172,0.1266264,174,558.4810793538745,447.8169541645224,110.66412518935215
293,2018-01-08,16476.20,16537.90,14208.20,15170.10,15170.10,18413899776,BTC,15287.661905,12581.852509291435,17993.471300708567,0.4782760187789919,81.3855250502755000000,15225.326667,-0.00362728946366061,-1,148321072400,14026.60,15170.10,0.0815236764433,2018-01-08,0.040590405,0.0,0.94833946,0.1859188,271,468.963028214921,452.04616897460215,16.916859240318843
294,2018-01-09,15123.70,15497.50,14424.00,14595.40,14595.40,16659999744,BTC,15136.171429,12670.040788386768,17602.30206961323,0.39036034423838745,65.3651525749760000000,15263.246667,-0.04375521680088694,-1,131661072656,16099.80,14595.40,-0.0934421545609,2018-01-09,0.045081966,0.0,0.93442625,0.0909057,244,347.63848071062785,431.1646313218073,-83.52615061117945
295,2018-01-10,14588.50,14973.30,13691.20,14973.30,14973.30,18500800512,BTC,15057.538095,12687.294987235575,17427.781202764425,0.4822300727878811,51.4098977004460000000,15188.146667,-0.01414568029335715,1,150161873168,15838.50,14973.30,-0.0546263850743,2018-01-10,0.016393442,0.0040983604,0.97131145,0.0774836,244,278.7678126543469,400.68526758831524,-121.91745493396832
296,2018-01-11,14968.20,15018.80,13105.90,13405.80,13405.80,16534099968,BTC,14943.390476,12494.337064655314,17392.44388734469,0.18608474015359136,34.6233715135087500000,15025.966667,-0.10782445501880468,-1,133627773200,14606.50,13405.80,-0.0822031287441,2018-01-11,0.01,0.0033333334,0.98,0.1591567,300,96.58973584162959,339.8661612389781,-243.27642539734853
297,2018-01-12,13453.90,14229.90,13158.10,13980.60,13980.60,12065699840,BTC,14950.476190,12514.102211395926,17386.850168604073,0.3009590895081526,28.1230873480807500000,14984.240000,-0.06697970667848353,1,145693473040,14656.20,13980.60,-0.0460965325255,2018-01-12,0.039130434,0.004347826,0.9434783,0.1522435,230,-1.3901219032195513,271.6149046105386,-273.00502651375814
298,2018-01-13,13952.40,14659.50,13952.40,14360.20,14360.20,12763599872,BTC,14934.333333,12486.501449611493,17382.16521638851,0.3827261510694041,26.8377852583720000000,14964.506667,-0.04038266549291785,1,158457072912,12952.20,14360.20,0.1087074010593,2018-01-13,0.014354067,0.009569378,0.9665072,0.123823,209,-47.85764439093691,207.72039481024348,-255.5780392011804
299,2018-01-14,14370.80,14511.80,13268.00,13772.00,13772.00,11084099584,BTC,14927.009524,12465.621397836421,17388.397650163577,0.26537436097080613,18.0144804900795000000,15019.160000,-0.08303793288040077,-1,147372973328,14156.40,13772.00,-0.0271537961629,2018-01-14,0.0,0.0070422534,0.97887325,0.0830282,142,-130.64037403510883,140.04824104117301,-270.68861507628185
300,2018-01-15,13767.30,14445.50,13641.70,13819.80,13819.80,12750799872,BTC,14917.161905,12439.045819360597,17395.277990639406,0.2785894875225628,18.0470880480912500000,14996.720000,-0.07847849396401346,1,160123773200,13657.20,13819.80,0.0119058079255,2018-01-15,0.013100437,0.0,0.9737991,0.1072533,229,-190.19675339716923,73.99924215350454,-264.1959955506738
301,2018-01-16,13836.10,13843.10,10194.90,11490.50,11490.50,18853799936,BTC,14697.671429,11867.937230780768,17527.405627219232,-0.06669128694459915,12.4271702374765000000,14852.273333,-0.22634739191949397,-1,141269973264,14982.10,11490.50,-0.2330514413867,2018-01-16,0.036363635,0.0036363637,0.95272726,0.1177636,275,-420.50335540878405,-24.90127735895321,-395.6020780498308
302,2018-01-17,11431.10,11678.00,9402.29,11188.60,11188.60,18830600192,BTC,14476.247619,11313.354258408122,17639.140979591877,-0.019721540403875106,4.7328448024847500000,14599.373333,-0.23362463957890486,-1,122439373072,15201.00,11188.60,-0.2639563186632,2018-01-17,0.017191976,0.008595988,0.96561605,0.1109771,349,-620.2341307104834,-143.9678480292593,-476.26628268122414
303,2018-01-18,11198.80,12107.30,10942.50,11474.90,11474.90,15020399616,BTC,14327.123810,10905.323179393497,17748.9244406065,0.08322764563076646,3.6406326416975000000,14350.966667,-0.20040926397059410,1,137459772688,15599.20,11474.90,-0.2643917636802,2018-01-18,0.0070921984,0.0035460992,0.9822695,0.1666773,282,-746.8114147149481,-264.5365613663971,-482.274853348551
304,2018-01-19,11429.80,11992.80,11172.10,11607.40,11607.40,10740400128,BTC,14181.942857,10565.602813491134,17798.282900508868,0.14404026916368592,2.7810646219865000000,14084.846667,-0.17589447195080352,1,148200172816,17429.50,11607.40,-0.3340371209731,2018-01-19,0.024875622,0.0,0.96517414,0.1521692,201,-826.9011795084898,-377.0094849948157,-449.8916945136741
305,2018-01-20,11656.20,13103.00,11656.20,12899.20,12899.20,11801700352,BTC,14179.419048,10559.40234824899,17799.43574775101,0.3231749803684532,9.5280354663637500000,13782.826667,-0.06411070010157300,1,160001873168,17527.00,12899.20,-0.2640383408456,2018-01-20,0.020833334,0.0052083335,0.9635417,0.1897188,192,-777.1766228194119,-457.042912559735,-320.13371025967695
306,2018-01-21,12889.20,12895.90,11288.20,11600.10,11600.10,9935179776,BTC,14057.690476,10266.54851985815,17848.832432141848,0.1758772812478608,11.4731101496687500000,13387.700000,-0.13352554957162171,-1,150066693392,16477.60,11600.10,-0.2960079137739,2018-01-21,0.036649216,0.0,0.9528796,0.1621675,191,-832.9938319856683,-532.2330964449217,-300.7607355407466
307,2018-01-22,11633.10,11966.40,10240.20,10931.40,10931.40,10537400320,BTC,13927.890476,9899.906430895175,17955.874521104826,0.12804092041506349,10.3438819532785000000,13017.953333,-0.16028274795782754,-1,139529293072,15170.10,10931.40,-0.2794114738861,2018-01-22,0.00913242,0.0,0.99086756,0.2044247,219,-920.5760462074959,-609.9016863974366,-310.6743598100593
308,2018-01-23,10944.50,11377.60,10129.70,10868.40,10868.40,9660609536,BTC,13732.000000,9523.281265277992,17940.71873472201,0.15980145259229997,8.6920455276822500000,12731.173333,-0.14631591953677786,-1,129868683536,14595.40,10868.40,-0.2553544267372,2018-01-23,0.014285714,0.0,0.98571426,0.190481,210,-983.729336025317,-684.6672163230128,-299.06211970230424
309,2018-01-24,10903.40,11501.40,10639.80,11359.40,11359.40,9940989952,BTC,13549.066667,9275.07368603556,17823.059647964437,0.24383829398499693,4.9354033149402500000,12515.440000,-0.09236910568066324,1,139809673488,14973.30,11359.40,-0.2413562808466,2018-01-24,0.024271844,0.004854369,0.9708738,0.1944951,206,-982.8297273538647,-744.2997185291832,-238.53000882468143
310,2018-01-25,11421.70,11785.70,11057.40,11259.40,11259.40,8873169920,BTC,13342.409524,9065.079606911651,17619.73944108835,0.2565058617902988,5.7897444057345000000,12267.846667,-0.08220241859662950,-1,130936503568,13405.80,11259.40,-0.1601098032195,2018-01-25,0.041237112,0.0,0.9536083,0.1897835,194,-978.9017749487557,-791.2201298130979,-187.68164513565785
311,2018-01-26,11256.00,11656.70,10470.30,11171.40,11171.40,9746199552,BTC,13044.404762,9104.308664453041,16984.50085954696,0.2623148375535684,7.9591126398830000000,12118.886667,-0.07818264936663097,-1,121190304016,13980.60,11171.40,-0.2009355821639,2018-01-26,0.060869563,0.013043478,0.92608696,0.1437913,230,-971.6886865974557,-827.3138411699696,-144.3748454274861
312,2018-01-27,11174.90,11614.90,10989.20,11440.70,11440.70,7583269888,BTC,12754.580952,9338.851438927255,16170.310465072746,0.307671985300433,12.0565695389035000000,11949.560000,-0.04258399472449195,1,128773573904,14360.20,11440.70,-0.2033049678974,2018-01-27,0.01734104,0.011560693,0.9653179,0.2266821,173,-933.481410122311,-848.5473549604379,-84.93405516187306
313,2018-01-28,11475.30,12040.30,11475.30,11786.30,11786.30,8350360064,BTC,12531.185714,9552.436861689208,15509.93456631079,0.3749666804869856,16.8413645773910000000,11777.966667,0.00070753579421724,1,137123933968,13772.00,11786.30,-0.1441838512925,2018-01-28,0.023364486,0.0,0.9766355,0.1973224,214,-865.3397386953002,-851.9058317074104,-13.433906987889827
314,2018-01-29,11755.50,11875.60,11179.20,11296.40,11296.40,7107359744,BTC,12346.723810,9582.270855142737,15111.176764857262,0.3100304423422117,17.6673469194400000000,11612.926667,-0.02725640797332006,-1,130016574224,13819.80,11296.40,-0.1825930910722,2018-01-29,0.030701755,0.0,0.9649123,0.1749342,228,-841.1713096423209,-849.7589272943925,8.587617652071572
315,2018-01-30,11306.80,11307.20,10036.20,10106.30,10106.30,8637859840,BTC,12132.957143,9404.795307938573,14861.118978061426,0.12856727981564758,15.4979786852915000000,11365.360000,-0.11078047681727636,-1,121378714384,11490.50,10106.30,-0.1204647317349,2018-01-30,0.0,0.010416667,0.9895833,0.1583802,192,-907.5866850582788,-861.32447884717,-46.26220621110883
316,2018-01-31,10108.20,10381.60,9777.42,10221.10,10221.10,8041160192,BTC,11906.661905,9387.67064064342,14425.653169356581,0.16542918809396123,12.4281275007612500000,11280.733333,-0.09393301851221058,1,129419874576,11188.60,10221.10,-0.0864719446580,2018-01-31,0.010869565,0.0054347827,0.9836956,0.2157391,184,-940.1208203836686,-877.0837471544698,-63.03707322919877
317,2018-02-01,10237.30,10288.80,8812.28,9170.54,9170.54,9959400448,BTC,11704.982857,9017.553981832192,14392.41173216781,0.028463268289892117,4.6530038306385000000,11146.196000,-0.17724935036132507,-1,119460474128,11474.90,9170.54,-0.2008174363175,2018-02-01,0.0049261083,0.0,0.9950739,0.1744335,203,-1038.7022560881978,-909.4074489412155,-129.2948071469823
318,2018-02-02,9142.28,9142.28,7796.49,8830.75,8830.75,12726899712,BTC,11459.751905,8705.437169479608,14214.06664052039,0.022748458791641255,1.0276057144902500000,10969.919333,-0.19500319629196311,-1,106733574416,11607.40,8830.75,-0.2392137774179,2018-02-02,0.009433962,0.0,0.990566,0.1352311,212,-1131.2071159006737,-953.7673823331071,-177.43973356756658
319,2018-02-03,8852.12,9430.75,8251.63,9174.91,9174.91,7263790080,BTC,11212.833333,8625.98941467533,13799.67725132467,0.10609851283183902,3.1424160230845000000,10807.753333,-0.15108073645744076,1,113997364496,12899.20,9174.91,-0.2887225564376,2018-02-03,0.0051282053,0.010256411,0.9846154,0.1993846,195,-1163.3368252596174,-995.6812709184093,-167.65555434120813
320,2018-02-04,9175.70,9334.87,8031.22,8277.01,8277.01,7073549824,BTC,10951.167143,8340.011122934231,13562.32316306577,-0.0120638373291543,2.1148103085942500000,10499.607333,-0.21168385278699260,-1,106923814672,11600.10,8277.01,-0.2864708062862,2018-02-04,0.016949153,0.0056497175,0.97740114,0.1425763,177,-1246.8796251804724,-1045.920941770822,-200.95868340965035
321,2018-02-05,8270.54,8364.84,6756.68,6955.27,6955.27,9285289984,BTC,10624.284762,7810.5710451366895,13437.998478863308,-0.1519879296906878,2.1148103085942500000,10189.952000,-0.31743839421422201,-1,97638524688,10931.40,6955.27,-0.3637347457782,2018-02-05,0.026700707,0.011701506,0.9594702,0.0975899,18801,-1403.5618801004202,-1117.4491294367417,-286.1127506636785
322,2018-02-06,7051.75,7850.70,6048.26,7754.00,7754.00,13999800320,BTC,10446.356190,7399.774496662523,13492.937883337478,0.05813490971079605,6.2481421239627500000,9978.125333,-0.22290011988968469,1,111638325008,10868.40,7754.00,-0.2865555187516,2018-02-06,0.032542255,0.008314979,0.95750946,0.1324546,40409,-1446.6072720744778,-1183.280757964289,-263.3265141101888
323,2018-02-07,7755.49,8509.11,7236.79,7621.30,7621.30,9169280000,BTC,10276.484762,7013.592354018275,13539.377169981726,0.09312407060912334,7.5799570691962500000,9761.652000,-0.21926124799367976,-1,102469045008,11359.40,7621.30,-0.3290754793387,2018-02-07,0.0046948357,0.0,0.9906103,0.2239437,213,-1474.432496303827,-1241.5111056321966,-232.92139067163043
324,2018-02-08,7637.86,8558.77,7637.86,8265.59,8265.59,9346750464,BTC,10123.660476,6796.51838457994,13450.802567420058,0.220770795934514,14.3607056880207500000,9555.398000,-0.13498213261237261,1,111815795472,11259.40,8265.59,-0.2658942750058,2018-02-08,0.0070422534,0.0,0.9929578,0.1367183,142,-1428.0338828510394,-1278.8156610759652,-149.2182217750742
325,2018-02-09,8271.84,8736.98,7884.71,8736.98,8736.98,6784820224,BTC,9986.973810,6680.059111695995,13293.888508304004,0.31100301579579964,23.5808409386815000000,9387.236667,-0.06927029647456528,1,118600615696,11171.40,8736.98,-0.2179153910880,2018-02-09,0.010416667,0.0,0.984375,0.2571823,192,-1337.8040417377251,-1290.6133372083173,-47.19070452940787
326,2018-02-10,8720.08,9122.55,8295.47,8621.90,8621.90,7780960256,BTC,9783.292857,6711.173565936306,12855.412148063695,0.31097855471004865,28.0721191961132500000,9217.270000,-0.06459287836854079,-1,110819655440,11440.70,8621.90,-0.2463835254836,2018-02-10,0.007575758,0.0,0.99242425,0.1201364,132,-1261.0456871133538,-1284.6998071893247,23.654120075970923
327,2018-02-11,8616.13,8616.13,7931.10,8129.97,8129.97,6122189824,BTC,9618.048571,6583.288158214267,12652.808983785731,0.2548276686471552,30.7044253502875000000,8996.554667,-0.09632405949565270,-1,104697465616,11786.30,8129.97,-0.3102186436795,2018-02-11,0.0125,0.00625,0.96875,0.1861438,160,-1225.778763266344,-1272.9155984047286,47.13683513838464
328,2018-02-12,8141.43,8985.92,8141.43,8926.57,8926.57,6256439808,BTC,9522.580476,6535.585090884875,12509.575861115123,0.40023244110619405,35.2761356534487500000,8805.906000,0.01370262185401479,1,110953905424,11296.40,8926.57,-0.2097863036011,2018-02-12,0.004830918,0.0,0.99033815,0.2092657,207,-1120.6325549734938,-1242.4589897184817,121.82643474498786
329,2018-02-13,8926.72,8958.47,8455.41,8598.31,8598.31,5696719872,BTC,9414.480952,6468.013330322106,12360.948573677893,0.3615000982879927,38.6335074989932500000,8626.033333,-0.00321391442969978,-1,105257185552,10106.30,8598.31,-0.1492128672214,2018-02-13,0.0056497175,0.0,0.98870057,0.1828362,177,-1051.6682885902756,-1204.3008494928406,152.63256090256505
330,2018-02-14,8599.92,9518.54,8599.92,9494.63,9494.63,7909819904,BTC,9325.682381,6516.1812835102355,12135.183478489766,0.5300671922055752,49.4477537046887500000,8585.255333,0.10592284465955790,1,113167005456,10221.10,9494.63,-0.0710755202473,2018-02-14,0.012578616,0.006289308,0.9811321,0.1517421,159,-914.1503216115034,-1146.270743916573,232.12042230506972
331,2018-02-15,9488.32,10234.80,9395.58,10166.40,10166.40,9062540288,BTC,9273.634762,6576.33476677797,11970.934757222029,0.6654923886073918,68.3688222966867500000,8581.608667,0.18467299016957143,1,122229545744,9170.54,10166.40,0.1085933870852,2018-02-15,0.015075377,0.0,0.9798995,0.1849648,199,-742.4021671799655,-1065.4970285692516,323.09486138928605
332,2018-02-16,10135.70,10324.10,9824.82,10233.90,10233.90,7296159744,BTC,9228.991905,6634.540900601429,11823.442909398573,0.6936648819531186,82.0163633747010000000,8652.499333,0.18276807730786565,1,129525705488,8830.75,10233.90,0.1588936387057,2018-02-16,0.0057803467,0.0,0.9884393,0.1785838,173,-593.9966083840154,-971.1969445322044,377.20033614818897
333,2018-02-17,10207.50,11139.50,10149.40,11112.70,11112.70,8660880384,BTC,9213.372857,6671.426338560694,11755.319375439307,0.8735969913651332,94.4388562784957500000,8804.629333,0.26214285459460352,1,138186585872,9174.91,11112.70,0.2112053415238,2018-02-17,0.032967035,0.0,0.96153843,0.2431593,182,-400.8515511126079,-857.1278658482851,456.27631473567715
334,2018-02-18,11123.40,11349.80,10326.00,10551.80,10551.80,8744009728,BTC,9154.587143,6813.37708480238,11495.797201197622,0.7983954498460599,96.6271230062802500000,8896.422000,0.18607233334929481,-1,129442576144,8277.01,10551.80,0.2748323367979,2018-02-18,0.024844721,0.0,0.9751553,0.2048571,161,-289.70312674172965,-743.642918026974,453.9397912852444
335,2018-02-19,10552.60,11273.80,10513.20,11225.30,11225.30,7652089856,BTC,9151.201429,6822.829835784814,11479.573022215187,0.9453968123137791,96.6271230062802500000,9092.974667,0.23450250452567328,1,137094666000,6955.27,11225.30,0.6139272810401,2018-02-19,0.012269938,0.0,0.9877301,0.1707485,163,-145.59307201564843,-624.0329488247089,478.4398768090605
336,2018-02-20,11231.80,11958.50,11231.80,11403.70,11403.70,9926540288,BTC,9212.982381,6715.465481918798,11710.499280081202,0.9385791383045161,96.6271230062802500000,9389.536667,0.21451147212395246,1,147021206288,7754.00,11403.70,0.4706860974981,2018-02-20,0.041237112,0.0,0.9536083,0.2052938,194,-16.79581464326293,-502.5855219884197,485.7897073451568
337,2018-02-21,11372.20,11418.50,10479.10,10690.40,10690.40,9405339648,BTC,9235.330000,6691.949287027597,11778.710712972403,0.7860503723603939,91.9125238100027500000,9585.296667,0.11529151067432476,-1,137615866640,7621.30,10690.40,0.4027003267159,2018-02-21,0.0057803467,0.0057803467,0.9884393,0.2090867,173,27.403698280013487,-396.58767793473305,423.99137621474654
338,2018-02-22,10660.40,11039.10,9939.09,10005.00,10005.00,8040079872,BTC,9275.066190,6709.955542916907,11840.176837083092,0.6422811547778733,84.6041595284800000000,9744.210000,0.02676358576015911,-1,129575786768,8265.59,10005.00,0.2104399081009,2018-02-22,0.009803922,0.0,0.9852941,0.1354804,204,7.0448699633871,-315.86116835510904,322.90603831849614
339,2018-02-23,9937.07,10487.30,9734.56,10301.10,10301.10,7739500032,BTC,9345.082857,6750.806747784614,11939.358966215384,0.6842550874989825,76.1841004521360000000,9879.910667,0.04263088475150076,1,137315286800,8736.98,10301.10,0.1790229575895,2018-02-23,0.013422819,0.040268455,0.94630873,0.1221879,149,14.63445039940234,-249.76204460420678,264.3964950036091
340,2018-02-24,10287.70,10597.20,9546.97,9813.07,9813.07,6917929984,BTC,9375.471429,6774.62529560198,11976.317562398019,0.584126193660729,64.0371763013967500000,9951.650000,-0.01392532896554843,-1,130397356816,8621.90,9813.07,0.1381563228523,2018-02-24,0.007633588,0.0,0.99236643,0.1417328,131,-18.517239576789507,-203.51308359872334,184.99584402193383
341,2018-02-25,9796.42,9923.22,9407.06,9664.73,9664.73,5706939904,BTC,9441.553333,6887.8363213377215,11995.270344662278,0.5436964366021763,55.4720456482365000000,10021.172000,-0.03556889353860008,-1,124690416912,8129.97,9664.73,0.1887780643717,2018-02-25,0.025,0.0,0.975,0.1558417,120,-56.1131534945398,-174.03309757788665,117.91994408334685
342,2018-02-26,9669.43,10475.00,9501.73,10366.70,10366.70,7287690240,BTC,9604.002381,7291.970336888979,11916.034425111022,0.6649409706372081,56.9121475453532500000,10170.287333,0.01931240097442388,1,131978107152,8926.57,10366.70,0.1613307238951,2018-02-26,0.006369427,0.006369427,0.9872612,0.1852293,157,-28.931568632620838,-145.01279178883348,116.08122315621264
343,2018-02-27,10393.90,10878.50,10246.10,10725.60,10725.60,6966179840,BTC,9745.507143,7548.125167829159,11942.889118170842,0.7230137654887698,59.2893747872642500000,10290.222667,0.04230980680293961,1,138944286992,8598.31,10725.60,0.2474079208589,2018-02-27,0.011627907,0.0,0.98255813,0.1640174,172,21.324448779143495,-111.74534367523808,133.06979245438157
344,2018-02-28,10687.20,11089.80,10393.10,10397.90,10397.90,6936189952,BTC,9877.726190,7893.353303131443,11862.099076868555,0.6310675562648062,58.2649642043372500000,10410.195333,-0.00118108571517618,-1,132008097040,9494.63,10397.90,0.0951348288454,2018-02-28,0.005235602,0.0,0.9947644,0.1642408,191,34.314497192655836,-82.5333755016593,116.84787269431513
345,2018-03-01,10385.00,11052.30,10352.70,10951.00,10951.00,7317279744,BTC,10005.602857,8113.60861468167,11897.59709931833,0.7498414429215099,65.0365311757495000000,10507.286667,0.04222910700567070,1,139325376784,10166.40,10951.00,0.0771757947749,2018-03-01,0.016574586,0.0,0.97790056,0.2243702,181,88.22277447158922,-48.38214550700958,136.6049199785988
346,2018-03-02,10977.40,11189.00,10850.10,11086.40,11086.40,7620590080,BTC,10117.480000,8263.075341992477,11971.884658007522,0.7612482652629503,69.7160622455087500000,10568.620000,0.04899220522641556,1,146945966864,10233.90,11086.40,0.0833015761342,2018-03-02,0.01863354,0.0,0.98136646,0.2218944,161,140.25435610638124,-10.65484518433141,150.90920129071264
347,2018-03-03,11101.90,11528.20,11002.40,11489.70,11489.70,6690570240,BTC,10254.041905,8440.279013124447,12067.804796875553,0.8406338558735886,75.7588940799417500000,10652.340000,0.07860808047809214,1,153636537104,11112.70,11489.70,0.0339251487037,2018-03-03,0.031446543,0.006289308,0.9622642,0.2025157,159,211.5935798246628,33.79483981746745,177.79874000719536
348,2018-03-04,11497.40,11512.60,11136.10,11512.60,11512.60,6084149760,BTC,10415.119524,8804.150860388243,12026.088187611756,0.8406275059191634,88.9302288136080000000,10679.000000,0.07805974342166870,1,159720686864,10551.80,11512.60,0.0910555545025,2018-03-04,0.029069768,0.0,0.9709302,0.2157035,172,266.90159179966577,80.41619021390713,186.48540158575864
349,2018-03-05,11532.40,11704.10,11443.90,11573.30,11573.30,6468539904,BTC,10541.154286,9007.001586891187,12075.306985108815,0.8363894984506984,95.4383916916335000000,10747.100000,0.07687655274446130,1,166189226768,11225.30,11573.30,0.0310013986263,2018-03-05,0.01764706,0.0,0.9823529,0.1829471,170,312.0346314746639,126.73987846605851,185.2947530086054
350,2018-03-06,11500.10,11500.10,10694.30,10779.90,10779.90,6832169984,BTC,10645.039524,9394.132403395497,11895.946644604503,0.5539050716790341,89.6074024007502500000,10717.406667,0.00583101257064579,-1,159357056784,11403.70,10779.90,-0.0547015442356,2018-03-06,0.02020202,0.0,0.97979796,0.2101768,198,280.5481567873776,157.50153413032237,123.04662265705522
351,2018-03-07,10803.90,10929.50,9692.12,9965.57,9965.57,8797910016,BTC,10667.465238,9488.353816859166,11846.576659140836,0.20236263282019148,68.5480490629110000000,10621.531333,-0.06175769881335245,-1,150559146768,10690.40,9965.57,-0.0678019531542,2018-03-07,0.010362694,0.005181347,0.98445594,0.2494819,193,187.72133865029173,163.54549503431625,24.17584361597548
352,2018-03-08,9951.44,10147.40,9335.87,9395.01,9395.01,7186089984,BTC,10630.732381,9343.001095460897,11918.463666539103,0.02019400519469788,43.5480490629110000000,10535.172000,-0.10822433653669821,-1,143373056784,10005.00,9395.01,-0.0609685157421,2018-03-08,0.014563107,0.004854369,0.98058254,0.2231019,206,67.3397422335529,144.30434447416357,-76.96460224061067
353,2018-03-09,9414.69,9466.35,8513.03,9337.55,9337.55,8704190464,BTC,10588.049048,9190.34773192557,11985.75036407443,0.05265869981716098,18.5480490629110000000,10490.675333,-0.10991907540715425,-1,134668866320,10301.10,9337.55,-0.0935385541350,2018-03-09,0.0,0.0,1.0,0.1651472,163,-32.327431508712834,108.97798927758828,-141.3054207863011
354,2018-03-10,9350.59,9531.32,8828.47,8866.00,8866.00,5386319872,BTC,10481.063333,8917.88232357936,12044.24434242064,-0.01659511063232203,3.9406466621607500000,10395.002000,-0.14709011118997380,-1,129282546448,9813.07,8866.00,-0.0965110816493,2018-03-10,0.020833334,0.0,0.9791667,0.2149097,144,-147.66236898184798,57.649917625701015,-205.312286607549
355,2018-03-11,8852.78,9711.89,8607.12,9578.63,9578.63,6296370176,BTC,10434.721905,8823.389630258145,12046.054179741855,0.23435277179650857,6.5806338418350000000,10379.372667,-0.07714750136545993,1,135578916624,9664.73,9578.63,-0.0089086813600,2018-03-11,0.018404908,0.0,0.9815951,0.2098344,163,-179.49376023315017,10.221182053930765,-189.71494228708093
356,2018-03-12,9602.93,9937.50,8956.43,9205.12,9205.12,6457399808,BTC,10338.522857,8684.767964301052,11992.277749698947,0.15732441306635464,9.7121671037565000000,10348.732000,-0.11050745154092308,-1,129121516816,10366.70,9205.12,-0.1120491573982,2018-03-12,0.013513514,0.0,0.9864865,0.1970541,148,-232.1830410113962,-38.25966255913465,-193.92337845226155
357,2018-03-13,9173.04,9470.38,8958.19,9194.85,9194.85,5991139840,BTC,10233.339524,8583.153032824217,11883.526015175785,0.18534176908088115,12.7488641820262500000,10270.608667,-0.10474147169646027,1,135112656656,10725.60,9194.85,-0.1427192884314,2018-03-13,0.0,0.0,1.0,0.1516612,183,-271.6371152278407,-84.93515309287586,-186.70196213496484
358,2018-03-14,9214.65,9355.85,8068.59,8269.81,8269.81,6438230016,BTC,10118.073333,8275.08071216471,11961.06595383529,-0.0014299330624346288,12.7488641820262500000,10106.889333,-0.18176505871116577,-1,128674426640,10397.90,8269.81,-0.2046653651218,2018-03-14,0.009708738,0.0,0.99029124,0.1973981,206,-373.2452119474583,-142.5971648637924,-230.64804708366592
359,2018-03-15,8290.76,8428.35,7783.05,8300.86,8300.86,6834429952,BTC,10036.923810,8030.220166065737,12043.627453934263,0.06743393194912865,6.4032091050732500000,9967.086667,-0.16717288839442977,1,135508856592,10951.00,8300.86,-0.2419998173683,2018-03-15,0.010989011,0.0054945056,0.98351645,0.2024286,182,-446.1222653665627,-203.30218496434648,-242.82008040221623
360,2018-03-16,8322.91,8585.15,8005.31,8338.35,8338.35,5289379840,BTC,9943.459524,7809.6266124113135,12077.292435588686,0.1238905316150177,3.7903697093357500000,9792.910000,-0.14853194811348210,1,140798236432,11086.40,8338.35,-0.2478757757252,2018-03-16,0.006451613,0.0,0.9935484,0.1762065,155,-495.1450022007175,-261.67074841162076,-233.47425378909674
361,2018-03-17,8321.91,8346.53,7812.82,7916.88,7916.88,4426149888,BTC,9853.164762,7542.969030607363,12163.360493392638,0.08092625319830273,0.7536726310660000000,9581.608667,-0.17374208495213218,-1,136372086544,11489.70,7916.88,-0.3109585106661,2018-03-17,0.01863354,0.0,0.98136646,0.1922733,161,-561.5319897237387,-321.64299667404435,-239.8889930496943
362,2018-03-18,7890.52,8245.51,7397.99,8223.68,8223.68,6639190016,BTC,9784.543333,7367.692174700564,12201.394491299436,0.17708741027762206,2.8513528756767500000,9363.874000,-0.12176520102683996,1,143011276560,11512.60,8223.68,-0.2856800375241,2018-03-18,0.005988024,0.0,0.994012,0.2003593,167,-582.6712877577593,-373.8486548907874,-208.8226328669719
363,2018-03-19,8344.12,8675.87,8182.40,8630.65,8630.65,6729110016,BTC,9701.874286,7250.144551836209,12153.604020163792,0.28153703667395424,7.4966258324240000000,9171.744000,-0.05899575914896883,1,149740386576,11573.30,8630.65,-0.2542619650402,2018-03-19,0.0061728396,0.0,0.99382716,0.1930556,162,-560.1284439068513,-411.1046126940002,-149.02383121285112
364,2018-03-20,8619.67,9051.02,8389.89,8913.47,8913.47,6361789952,BTC,9615.582381,7187.7402000837465,12043.424561916254,0.3554040319179586,15.6801939134147500000,8994.422000,-0.00900024481839967,1,156102176528,10779.90,8913.47,-0.1731398250448,2018-03-20,0.0,0.0,0.99473685,0.2224474,190,-513.5223019278692,-431.588150540774,-81.9341513870952
365,2018-03-21,8937.48,9177.37,8846.33,8929.28,8929.28,6043129856,BTC,9545.648095,7127.865164812769,11963.431025187232,0.372534443166023,28.0344300350340000000,8871.047333,0.00656435083864071,-1,150059046672,9965.57,8929.28,-0.1039870273351,2018-03-21,0.0,0.0,1.0,0.2512412,170,-469.89421574003063,-439.2493635806253,-30.644852159405332
366,2018-03-22,8939.44,9100.71,8564.90,8728.47,8728.47,5530390016,BTC,9439.813333,7086.691295481902,11792.935370518098,0.348851159935956,38.1466189043092500000,8788.574000,-0.00683887966352676,-1,144528656656,9395.01,8728.47,-0.0709461724894,2018-03-22,0.0056179776,0.0,0.994382,0.1407978,178,-446.3767782339946,-440.6748465112992,-5.701931722695406
367,2018-03-23,8736.25,8879.62,8360.62,8879.62,8879.62,5954120192,BTC,9334.728571,7096.131394808754,11573.325747191246,0.3983496057619617,47.7501944731870000000,8754.214667,0.01432513797870751,1,150482776848,9337.55,8879.62,-0.0490417721993,2018-03-23,0.013605442,0.006802721,0.97959185,0.1968503,147,-410.806970749396,-434.7012713589186,23.89430060952259
368,2018-03-24,8901.95,8996.18,8665.70,8668.12,8668.12,5664600064,BTC,9200.367619,7176.611628778801,11224.1236092212,0.3685000510012513,50.3498732511515000000,8709.586000,-0.00476096108356930,-1,144818176784,8866.00,8668.12,-0.0223189713512,2018-03-24,0.02,0.0,0.98,0.25392,150,-395.12912191388205,-426.7868414699112,31.65771955602918
369,2018-03-25,8612.81,8682.01,8449.10,8495.78,8495.78,4569880064,BTC,9056.709524,7313.461058961513,10799.957989038487,0.3391137192288836,46.7048292462767500000,8684.904667,-0.02177625135237423,-1,140248296720,9578.63,8495.78,-0.1130485257286,2018-03-25,0.0074074073,0.0,0.9925926,0.1845407,135,-392.09093126595326,-419.8476594291196,27.756728163166315
370,2018-03-26,8498.47,8530.08,7921.43,8209.40,8209.40,5921039872,BTC,8896.523810,7551.872692847655,10241.174927152346,0.24449736395000082,40.1716973863185000000,8593.622667,-0.04471020917353480,-1,134327256848,9205.12,8209.40,-0.1081702356949,2018-03-26,0.019736841,0.0065789474,0.9736842,0.2378684,152,-408.0874379518573,-417.4956151336671,9.408177181809833
371,2018-03-27,8200.00,8232.78,7797.28,7833.04,7833.04,5378250240,BTC,8756.197143,7641.674641510814,9870.719644489185,0.08585082770132081,25.6878700958115000000,8502.150667,-0.07869898960942514,-1,128949006608,9194.85,7833.04,-0.1481057331006,2018-03-27,0.0064102565,0.057692308,0.9358974,0.1717436,156,-445.99276441001166,-423.1950449889361,-22.797719421075556
372,2018-03-28,7836.83,8122.89,7809.17,7954.48,7954.48,4935289856,BTC,8660.430952,7640.786379300184,9680.075524699816,0.15382498426349536,17.1553959108460000000,8419.459333,-0.05522674492618753,1,133884296464,8269.81,7954.48,-0.0381302593409,2018-03-28,0.025,0.06875,0.90625,0.2321625,160,-460.92060976144785,-430.7401579434385,-30.180451818009374
373,2018-03-29,7979.07,7994.33,7081.38,7165.70,7165.70,6361229824,BTC,8554.273333,7400.468213036782,9708.078452963216,-0.10173651034078716,8.4462037941015000000,8345.852000,-0.14140581452918168,-1,127523066640,8300.86,7165.70,-0.1367520955660,2018-03-29,0.00990099,0.0990099,0.8910891,0.1460743,202,-530.286179654875,-450.64936228572583,-79.63681736914918
374,2018-03-30,7171.45,7276.66,6683.93,6890.52,6890.52,6289509888,BTC,8437.748095,7131.934682714477,9743.561507285523,-0.09243842973397574,2.7694665401737500000,8251.829333,-0.16497061173526333,-1,121233556752,8338.35,6890.52,-0.1736350716868,2018-03-30,0.0,0.08,0.9066667,0.12964,150,-600.5409574385512,-480.6276813162909,-119.91327612226036
375,2018-03-31,6892.48,7207.85,6863.52,6973.53,6973.53,4553269760,BTC,8347.630476,6911.264688013162,9783.996263986837,0.021674601451663063,3.7873646743337500000,8160.841333,-0.14548883926941066,1,125786826512,7916.88,6973.53,-0.1191567890381,2018-03-31,0.0064935065,0.064935066,0.9285714,0.1378506,154,-642.1182225689136,-512.9257895668154,-129.19243300209814
376,2018-04-01,7003.06,7060.95,6526.87,6844.23,6844.23,4532100096,BTC,8217.420952,6754.236641888594,9680.605262111407,0.030752570776457232,1.0178981341600000000,8089.331333,-0.15391894357456652,-1,121254726416,8223.68,6844.23,-0.1677412058835,2018-04-01,0.0068965517,0.089655176,0.9034483,0.1217379,145,-677.6899462742485,-545.8786209083021,-131.81132536594646
377,2018-04-02,6844.86,7135.47,6816.58,7083.80,7083.80,4333440000,BTC,8116.405714,6646.725270031702,9586.086157968299,0.1486971986876781,3.8903712163402500000,8013.339333,-0.11599899796730597,1,125588166416,8630.65,7083.80,-0.1792275205228,2018-04-02,0.007352941,0.05882353,0.9338235,0.1445074,136,-678.7255708721732,-572.4480109010764,-106.27755997109682
378,2018-04-03,7102.26,7530.94,7072.49,7456.11,7456.11,5499700224,BTC,8033.608571,6624.439405451934,9442.777736548065,0.2950925321391791,11.2268859282177500000,7935.036667,-0.06035594882525828,1,131087866640,8913.47,7456.11,-0.1635008588126,2018-04-03,0.05099572,0.013028104,0.9329983,0.2047478,10746,-642.102250305059,-586.378858781873,-55.723391523186024
379,2018-04-04,7456.41,7469.88,6803.88,6853.84,6853.84,4936000000,BTC,7966.181429,6471.56598404721,9460.79687395279,0.1278837366640705,10.3242128486127500000,7797.728000,-0.12104654073596822,-1,126151866640,8929.28,6853.84,-0.2324308342890,2018-04-04,0.04977356,0.009885037,0.9382512,0.1898095,22964,-654.1356914526941,-599.9302253160372,-54.20546613665692
380,2018-04-05,6848.65,6933.82,6644.80,6811.47,6811.47,5639320064,BTC,7895.258095,6327.770112582027,9462.746077417974,0.15429141812999048,10.3242128486127500000,7656.540667,-0.11037238666311651,-1,120512546576,8728.47,6811.47,-0.2196261200417,2018-04-05,0.046685006,0.015149703,0.93517524,0.1601444,25083,-659.4890064093561,-611.8419815347011,-47.64702487465502
381,2018-04-06,6815.96,6857.49,6575.00,6636.32,6636.32,3766810112,BTC,7814.209048,6168.867766916896,9459.550329083104,0.14205327443537646,7.4517397664325000000,7517.064000,-0.11716595734717704,-1,116745736464,8879.62,6636.32,-0.2526346848176,2018-04-06,0.04549871,0.013391914,0.93810993,0.1698367,23671,-670.1397345787127,-623.5015321435035,-46.63820243520922
382,2018-04-07,6630.51,7050.54,6630.51,6911.09,6911.09,3976610048,BTC,7766.314286,6075.595487777522,9457.033084222478,0.24708263523800286,3.4960942345925000000,7385.828667,-0.06427696720357729,1,120722346512,8668.12,6911.09,-0.2027002394983,2018-04-07,0.04527585,0.020311886,0.9315948,0.1928104,15262,-648.9284277646366,-628.5869112677301,-20.34151649690648
383,2018-04-08,6919.98,7111.56,6919.98,7023.52,7023.52,3652499968,BTC,7709.163810,6002.317565483801,9416.010054516199,0.29914892386972336,8.5866816202082500000,7276.188667,-0.03472541443928449,1,124374846480,8495.78,7023.52,-0.1732930937477,2018-04-08,0.007142857,0.071428575,0.92142856,0.1439071,140,-615.9459118531568,-626.0587113848155,10.112799531658766
384,2018-04-09,7044.32,7178.11,6661.99,6770.73,6770.73,4894060032,BTC,7620.596190,5921.572173589681,9319.620206410318,0.24989576904404526,10.7227776865240000000,7161.185333,-0.05452384135356939,-1,119480786448,8209.40,6770.73,-0.1752466684532,2018-04-09,0.016260162,0.024390243,0.9593496,0.135374,123,-603.2511667731824,-621.497202462489,18.24603568930661
385,2018-04-10,6795.44,6872.41,6704.15,6834.76,6834.76,4272750080,BTC,7521.610000,5898.423917716147,9144.796082283852,0.28842536678432185,14.4863572216335000000,7069.542667,-0.03321044628472853,1,123753536528,7833.04,6834.76,-0.1274447724000,2018-04-10,0.012345679,0.086419754,0.90123457,0.1390741,162,-581.3226779866154,-613.4622975673143,32.13961958069888
386,2018-04-11,6843.47,6968.32,6817.59,6968.32,6968.32,4641889792,BTC,7428.230952,5923.894041159814,8932.567862840186,0.34713831433440806,17.4021439862460000000,7011.894667,-0.00621439269546860,1,128395426320,7954.48,6968.32,-0.1239754201406,2018-04-11,0.01863354,0.099378884,0.8757764,0.1361118,161,-546.8631192166667,-600.1424618971848,53.279342680518084
387,2018-04-12,6955.38,7899.23,6806.51,7889.25,7889.25,8906250240,BTC,7388.268095,5988.016184883553,8788.520005116447,0.6788899202281173,37.1963315460752500000,7007.546000,0.12582207808553808,1,137301676560,7165.70,7889.25,0.1009740848766,2018-04-12,0.018072288,0.05421687,0.92771083,0.1947048,166,-440.16832964800597,-568.1476354473491,127.97930579934314
388,2018-04-13,7901.09,8183.96,7758.93,7895.96,7895.96,7764460032,BTC,7341.427143,6093.142555734054,8589.711730265946,0.72211796198436,60.0602354797595000000,7056.230000,0.11900547459479070,-1,129537216528,6890.52,7895.96,0.1459164184996,2018-04-13,0.02631579,0.047368422,0.9263158,0.2328947,190,-351.02411184181346,-524.722930726242,173.69881888442853
389,2018-04-14,7874.67,8140.71,7846.00,7986.24,7986.24,5191430144,BTC,7308.956667,6175.413481297164,8442.499852702837,0.7987461534516042,81.2966559446500000000,7129.278000,0.12020319589164569,1,134728646672,6973.53,7986.24,0.1452220037771,2018-04-14,0.0,0.056,0.944,0.200248,125,-269.9796778131249,-473.77428014361857,203.79460233049366
390,2018-04-15,7999.33,8338.42,7999.33,8329.11,8329.11,5244480000,BTC,7301.020000,6200.525459895417,8401.514540104583,0.967103635017716,100.0000000000000000000,7219.650000,0.15367226943134362,1,139973126672,6844.23,8329.11,0.2169535506551,2018-04-15,0.025974026,0.058441557,0.91558444,0.1904481,154,-176.0551818896456,-414.23046049282397,238.17527860317836
391,2018-04-16,8337.57,8371.15,7925.73,8058.67,8058.67,5631309824,BTC,7293.842381,6216.508766971277,8371.175995028725,0.8549632207891024,96.0060019258147500000,7300.612667,0.10383475573585035,-1,134341816848,7083.80,8058.67,0.1376196391767,2018-04-16,0.007352941,0.05147059,0.9411765,0.1357059,136,-122.03484825284795,-355.7913380448288,233.75648979198087
392,2018-04-17,8071.66,8285.96,7881.72,7902.09,7902.09,6900879872,BTC,7297.130476,6212.488357115137,8381.772594884864,0.7788751761834436,89.6995492648232500000,7355.165333,0.07435926212917939,-1,127440936976,7456.11,7902.09,0.0598140317136,2018-04-17,0.024844721,0.031055901,0.94409937,0.157913,161,-90.8112267624465,-302.79531578835235,211.98408902590586
393,2018-04-18,7944.43,8197.80,7886.01,8163.42,8163.42,6529909760,BTC,7307.080000,6193.660679222783,8420.499320777217,0.8845541315926853,87.2525534768047500000,7402.319333,0.10281921554058954,1,133970846736,6853.84,8163.42,0.1910724498967,2018-04-18,0.0076923077,0.1,0.8923077,0.1021538,130,-44.466552070394755,-251.12956304476083,206.66301097436607
394,2018-04-19,8159.27,8298.69,8138.78,8294.31,8294.31,7063209984,BTC,7360.823333,6169.815992597208,8551.830673402794,0.8918895523701382,86.7386090418777500000,7498.350667,0.10615125490236025,1,141034056720,6811.47,8294.31,0.2176975014204,2018-04-19,0.012658228,0.07594936,0.9113924,0.0954177,158,2.791487099392725,-200.34535301593013,203.13684011532285
395,2018-04-20,8286.88,8880.23,8244.54,8845.83,8845.83,8438110208,BTC,7453.933333,6120.179751181629,8787.68691481837,1.0217967868931082,90.7326071160630000000,7633.974667,0.15874500320764557,1,149472166928,6636.32,8845.83,0.3329420522217,2018-04-20,0.02255639,0.067669176,0.9097744,0.0887895,133,83.78110198057038,-143.52006201663002,227.3011639972004
396,2018-04-21,8848.79,8997.57,8652.15,8895.58,8895.58,7548550144,BTC,7545.459524,6091.765407653977,8999.153640346023,0.9643757104120487,97.0390597770545000000,7784.592000,0.14271627851530305,1,157020717072,6911.09,8895.58,0.2871457324387,2018-04-21,0.016129032,0.06451613,0.91129035,0.1172258,124,150.2483945287231,-84.76637070755937,235.01476523628247
397,2018-04-22,8925.06,9001.64,8779.61,8802.46,8802.46,6629899776,BTC,7638.708571,6123.990300887888,9153.426841112112,0.8841478154593936,98.3904488163612500000,7910.683333,0.11273067438812621,-1,150390817296,7023.52,8802.46,0.2532832539809,2018-04-22,0.01986755,0.059602648,0.9205298,0.1478477,151,193.183300148743,-29.176436536298887,222.3597366850419
398,2018-04-23,8794.39,8958.55,8788.81,8930.88,8930.88,6925190144,BTC,7726.664762,6134.736462928474,9318.593061071526,0.8782253380074794,98.9043932512882500000,8037.840667,0.11110438362711576,1,157316007440,6770.73,8930.88,0.3190424075395,2018-04-23,0.0057142857,0.08,0.9085714,0.1215657,175,234.86457036216234,23.631764843393377,211.23280551876897
399,2018-04-24,8934.34,9732.61,8927.83,9697.50,9697.50,10678800384,BTC,7833.397619,6031.013628570605,9635.781609429396,1.017121321232969,98.9043932512882500000,8232.958667,0.17788760908885540,1,167994807824,6834.76,9697.50,0.4188501132446,2018-04-24,0.0,0.033519555,0.96648043,0.1970279,179,325.99918867338965,84.10524960939266,241.89393906399698
400,2018-04-25,9701.03,9745.32,8799.84,8845.74,8845.74,11083100160,BTC,7928.250000,6132.73849881712,9723.76150118288,0.7554954394320389,91.1020496902185000000,8367.024000,0.05721460820478105,-1,156911707664,6968.32,8845.74,0.2694221849743,2018-04-25,0.008,0.048,0.936,0.091184,125,325.7391980206685,132.43203929164784,193.30715872902064
401,2018-04-26,8867.32,9281.51,8727.09,9281.51,9281.51,8970559488,BTC,8045.870952,6234.0820925364615,9857.65981146354,0.8409997366817527,86.4463775781532500000,8521.236667,0.08922100895804165,1,165882267152,7889.25,9281.51,0.1764755838641,2018-04-26,0.02739726,0.034246575,0.9246575,0.1818699,146,356.5856532298385,177.26276207928598,179.32289115055252
402,2018-04-27,9290.63,9375.47,8987.05,8987.05,8987.05,7566289920,BTC,8157.810476,6422.948010448609,9892.672941551391,0.7389928713272502,76.5874513261687500000,8594.423333,0.04568388730543813,-1,158315977232,7895.96,8987.05,0.1381833241303,2018-04-27,0.0,0.042016808,0.9411765,0.1133866,119,353.1997631147442,212.45016228637766,140.74960082836654
403,2018-04-28,8939.27,9412.09,8931.99,9348.48,9348.48,7805479936,BTC,8273.876667,6563.36666883766,9984.386665162341,0.8141178169535642,71.7275585997162500000,8691.258000,0.07561874241910665,1,166121457168,7986.24,9348.48,0.1705733862243,2018-04-28,0.007518797,0.067669176,0.924812,0.1464887,133,375.35395447055635,245.03092072321343,130.32303374734292
404,2018-04-29,9346.41,9531.49,9193.71,9419.08,9419.08,8853000192,BTC,8387.950952,6708.4242714152015,10067.477632584796,0.80697013031105,75.6530717989187500000,8786.780667,0.07196029546688126,1,174974457360,8329.11,9419.08,0.1308627212271,2018-04-29,0.014925373,0.02238806,0.95522386,0.2064776,134,394.0655977895476,274.8378561364803,119.22774165306731
405,2018-04-30,9426.11,9477.14,9166.81,9240.55,9240.55,8673920000,BTC,8505.561429,6961.210809816834,10049.912048183165,0.7379603963861355,75.0415978622845000000,8847.543333,0.04441986348166779,-1,166300537360,8058.67,9240.55,0.1466594363586,2018-04-30,0.007751938,0.062015504,0.92248064,0.0504031,129,389.99323175412064,297.86893126000837,92.12430049411228
406,2018-05-01,9251.47,9255.88,8891.05,9119.01,9119.01,7713019904,BTC,8614.335238,7253.352553574969,9975.31792242503,0.6854082229610469,76.8454002149925000000,8918.232667,0.02251313017913665,-1,158587517456,7902.09,9119.01,0.1539997646192,2018-05-01,0.006849315,0.10273973,0.89041096,0.0696575,146,372.6627656949786,312.8276981470024,59.835067547976166
407,2018-05-02,9104.60,9256.52,9015.14,9235.92,9235.92,7558159872,BTC,8722.316190,7565.2930112265385,9879.33936877346,0.7219505276222998,74.1831950065262500000,9007.154667,0.02539817972018843,1,166145677328,8163.42,9235.92,0.1313787603725,2018-05-02,0.006134969,0.0797546,0.9141104,0.1767485,163,364.1640499427158,323.0949685061451,41.069081436570684
408,2018-05-03,9233.97,9798.33,9188.15,9743.86,9743.86,10207299584,BTC,8810.630952,7637.662391672747,9983.599512327251,0.8978065054615084,78.0600253683935000000,9112.517333,0.06928301411440509,1,176352976912,8294.31,9743.86,0.1747643866699,2018-05-03,0.025157232,0.044025157,0.9308176,0.2105849,159,393.8749244964383,337.2509597042038,56.62396479223452
409,2018-05-04,9695.50,9779.20,9585.96,9700.76,9700.76,8217829888,BTC,8896.573810,7740.730107824378,10052.417512175622,0.8478784322163527,83.2782062516342500000,9206.280667,0.05371108603851997,1,184570806800,8845.83,9700.76,0.0966477990194,2018-05-04,0.006666667,0.046666667,0.94,0.18304,150,409.22589544882794,351.6459468531287,57.57994859569925
410,2018-05-05,9700.28,9964.50,9695.12,9858.15,9858.15,7651939840,BTC,8985.712381,7836.022417454962,10135.402344545037,0.87942299518292,91.3333301509107500000,9273.768667,0.06301443932707492,1,192222746640,8895.58,9858.15,0.1082076716751,2018-05-05,0.0074074073,0.06666667,0.9259259,0.1012519,135,429.14479411011416,367.1457163045258,61.99907780558834
411,2018-05-06,9845.31,9940.14,9465.25,9654.80,9654.80,7222280192,BTC,9048.840476,7905.004969286274,10192.675982713725,0.7648805359001926,94.0398572269600000000,9324.383333,0.03543576611984835,-1,185000466448,8802.46,9654.80,0.0968297498654,2018-05-06,0.019480519,0.058441557,0.9220779,0.1403442,154,423.6385774588689,378.4442885353945,45.1942889234744
412,2018-05-07,9645.67,9665.85,9231.53,9373.01,9373.01,7394019840,BTC,9111.428095,8054.622982491188,10168.23320750881,0.6237607113666476,82.0600269210562500000,9362.420000,0.00113111780928435,-1,177606446608,8930.88,9373.01,0.0495057597907,2018-05-07,0.024844721,0.049689442,0.9254658,0.1809627,161,392.0178256385625,381.15899595602815,10.858829682534349
413,2018-05-08,9380.87,9462.75,9127.77,9234.82,9234.82,7415869952,BTC,9174.891429,8274.632280259244,10075.150577740755,0.533284066640048,67.8123664392607500000,9382.682667,-0.01575910347261881,-1,170190576656,9697.50,9234.82,-0.0477112657902,2018-05-08,0.052287582,0.052287582,0.89542484,0.1956209,153,351.7525890199322,375.277714568809,-23.525125548876815
414,2018-05-09,9223.73,9374.76,9031.62,9325.18,9325.18,7226890240,BTC,9230.213333,8457.222504818104,10003.204161181895,0.5614280684438171,54.6514434930235000000,9357.861333,-0.00349239338317090,1,177417466896,8845.74,9325.18,0.0542001008395,2018-05-09,0.015873017,0.08730159,0.8968254,0.1191825,126,323.4053798284749,364.9032476207422,-41.4978677922673
415,2018-05-10,9325.96,9396.04,9040.52,9043.94,9043.94,6906699776,BTC,9265.910000,8614.818990171112,9917.001009828888,0.329539959353505,36.0997201262012500000,9371.074667,-0.03490898094665667,-1,170510767120,9281.51,9043.94,-0.0255960506426,2018-05-10,0.050847456,0.0,0.9491525,0.1669915,118,275.0753967886867,346.93767745433115,-71.86228066564445
416,2018-05-11,9052.96,9052.96,8394.46,8441.49,8441.49,8488520192,BTC,9246.655714,8523.466476315383,9969.844951684618,-0.0566770577074969,23.0795504321050000000,9315.073333,-0.09378169143394762,-1,162022246928,8987.05,8441.49,-0.0607051257087,2018-05-11,0.023076924,0.0,0.97692305,0.1676769,130,186.01657364596213,314.7534566926574,-128.73688304669525
417,2018-05-12,8441.44,8664.86,8223.50,8504.89,8504.89,6821380096,BTC,9228.051429,8448.986980208098,10007.1158777919,0.035878302416822466,14.5906116225595000000,9282.929333,-0.08381398856868794,1,168843627024,9348.48,8504.89,-0.0902381991511,2018-05-12,0.029850746,0.014925373,0.9477612,0.1755522,134,119.17884527321803,275.63853440876954,-156.4596891355515
418,2018-05-13,8515.49,8773.55,8395.12,8723.94,8723.94,5866379776,BTC,9224.312381,8435.970608013062,10012.654153986938,0.18264247934994945,7.7359697896685000000,9241.293333,-0.05598278448240228,1,174710006800,9419.08,8723.94,-0.0738012629684,2018-05-13,0.041322313,0.0661157,0.88429755,0.1617273,121,82.92901426581557,237.09663038017874,-154.16761611436317
419,2018-05-14,8713.10,8881.12,8367.97,8716.79,8716.79,7364149760,BTC,9214.117619,8404.58595642207,10023.649281577931,0.19283003865699705,10.9615221718692500000,9194.474000,-0.05195337982357664,1,182074156560,9240.55,8716.79,-0.0566806088382,2018-05-14,0.026490066,0.0794702,0.89403975,0.1866225,151,53.01271915442521,200.27984813502803,-147.26712898060282
420,2018-05-15,8705.19,8836.19,8456.45,8510.38,8510.38,6705710080,BTC,9157.588095,8324.378836107157,9990.797353892842,0.11161731696308712,12.1772337752180000000,9145.796000,-0.06947629271416069,-1,175368446480,9119.01,8510.38,-0.0667429907413,2018-05-15,0.035928145,0.07185629,0.89221555,0.1020838,167,12.504137865962548,162.72470608121495,-150.2205682152524
421,2018-05-16,8504.41,8508.43,8175.49,8368.83,8368.83,6760220160,BTC,9134.878095,8242.101771644164,10027.654418355836,0.07097423231357677,11.0584049807295000000,9095.784000,-0.07992208258243599,-1,168608226320,9235.92,8368.83,-0.0938823636411,2018-05-16,0.024691358,0.055555556,0.9197531,0.2014938,162,-30.66758978586404,124.04624690779914,-154.71383669366318
422,2018-05-17,8370.05,8445.54,8054.12,8094.32,8094.32,5862530048,BTC,9078.345238,8080.408084755989,10076.28239124401,0.006970336357749107,6.0739697598577500000,9019.677333,-0.10259317477072325,-1,162745696272,9743.86,8094.32,-0.1692901991613,2018-05-17,0.036764707,0.036764707,0.9264706,0.1697647,136,-86.04033834742404,82.0289298567545,-168.06926820417854
423,2018-05-18,8091.83,8274.12,7974.82,8250.97,8250.97,5764190208,BTC,9043.293810,7982.180515606302,10104.407104393696,0.1266544702690203,3.4360219507177500000,8920.151333,-0.07501905606963989,1,168509886480,9700.76,8250.97,-0.1494511770212,2018-05-18,0.008368201,0.058577407,0.9330544,0.1797908,239,-115.94673293728192,42.43379729794721,-158.38053023522912
424,2018-05-19,8255.73,8372.06,8183.35,8247.18,8247.18,4712399872,BTC,8990.850952,7885.164704823076,10096.537199176924,0.16370615809920488,4.3869023658742500000,8823.246000,-0.06528957710121649,-1,163797486608,9858.15,8247.18,-0.1634150423761,2018-05-19,0.023076924,0.03846154,0.93846154,0.1684,130,-138.35867476195926,6.275302885965905,-144.63397764792518
425,2018-05-20,8246.99,8562.41,8205.24,8513.25,8513.25,5191059968,BTC,8947.716190,7841.519084860482,10053.913295139517,0.3036217108228634,11.0984590663767500000,8733.586000,-0.02522858308145131,1,168988546576,9654.80,8513.25,-0.1182365248374,2018-05-20,0.0,0.06875,0.93125,0.187275,160,-133.11619414298002,-21.60299651982329,-111.51319762315673
426,2018-05-21,8522.33,8557.52,8365.12,8418.99,8418.99,5154990080,BTC,8908.594286,7787.878538853178,10029.310033146821,0.28156625029742793,17.4461664856887500000,8651.198667,-0.02684121310099605,-1,163833556496,9373.01,8418.99,-0.1017837386283,2018-05-21,0.02970297,0.08415841,0.8861386,0.1876139,202,-135.01116010653823,-44.284629237166286,-90.72653086937194
427,2018-05-22,8419.87,8423.25,8004.58,8041.78,8041.78,5137010176,BTC,8857.297619,7679.855233625586,10034.740004374416,0.15369107264612572,15.2258561383197500000,8562.450000,-0.06080853026878989,-1,158696546320,9234.82,8041.78,-0.1291893074256,2018-05-22,0.02238806,0.041044775,0.9365672,0.2100149,268,-165.04805754116023,-68.4373148979651,-96.61074264319514
428,2018-05-23,8037.08,8054.66,7507.88,7557.82,7557.82,6491120128,BTC,8777.388095,7485.641691287274,10069.134498712727,0.027938265787027437,13.0592641198145000000,8450.650000,-0.10565222793512925,-1,152205426192,9325.18,7557.82,-0.1895255641178,2018-05-23,0.025974026,0.058441557,0.91558444,0.1593442,154,-225.3068454737986,-99.81122101313181,-125.49562446066679
429,2018-05-24,7561.12,7738.60,7331.14,7587.34,7587.34,6049220096,BTC,8674.696667,7362.924258061111,9986.46907593889,0.0855391302674304,6.8443025798642500000,8334.794000,-0.08967876110675321,1,158254646288,9043.94,7587.34,-0.1610581228978,2018-05-24,0.025316456,0.07594936,0.89873415,0.1335,158,-267.59567538713236,-133.36811188793195,-134.22756349920041
430,2018-05-25,7592.30,7659.14,7392.65,7480.14,7480.14,4867829760,BTC,8568.952857,7246.600626175808,9891.305087824192,0.08830452597286888,0.4965951605522500000,8230.540667,-0.09117270630940435,-1,153386816528,8441.49,7480.14,-0.1138839233358,2018-05-25,0.020547945,0.11643836,0.8630137,0.1106644,146,-306.2299931210882,-167.94048813456322,-138.289504986525
431,2018-05-26,7486.48,7595.16,7349.12,7355.88,7355.88,4051539968,BTC,8449.797143,7164.928758594145,9734.665527405854,0.07430770486821285,0.4965951605522500000,8158.166667,-0.09834153918983671,-1,149335276560,8504.89,7355.88,-0.1350999248668,2018-05-26,0.018518519,0.074074075,0.9074074,0.1297963,108,-342.9217236178238,-202.93673523121535,-139.98498838660842
432,2018-05-27,7362.08,7381.74,7270.96,7368.22,7368.22,4056519936,BTC,8340.912381,7098.073908986766,9583.750853013235,0.10868109456558483,0.7220969660285000000,8082.388667,-0.08836108932943499,1,153391796496,8723.94,7368.22,-0.1554022609050,2018-05-27,0.021052632,0.05263158,0.9263158,0.1806947,95,-366.7764785811587,-235.70468390120405,-131.07179467995465
433,2018-05-28,7371.31,7419.05,7100.89,7135.99,7135.99,5040600064,BTC,8234.387619,6979.6723713377305,9489.102866662268,0.062292073422042786,0.2255018054762500000,7976.525333,-0.10537612530641480,-1,148351196432,8716.79,7135.99,-0.1813511625266,2018-05-28,0.004672897,0.046728972,0.94392526,0.0637804,214,-399.81178257145166,-268.5261036352536,-131.28567893619805
434,2018-05-29,7129.46,7526.42,7090.68,7472.59,7472.59,5662660096,BTC,8150.471905,6941.9071663182995,9359.0366436817,0.21955085097905813,6.3354592572282500000,7893.578667,-0.05333305522880146,1,154013856528,8510.38,7472.59,-0.1219440260012,2018-05-29,0.024590164,0.09016393,0.8770492,0.1685328,122,-394.286601565881,-293.6782032213791,-100.60839834450195
435,2018-05-30,7469.73,7573.77,7313.60,7406.52,7406.52,4922540032,BTC,8059.107143,6936.48779064333,9181.72649535667,0.20934620820937672,11.2461151972832500000,7819.988000,-0.05287322691543772,-1,149091316496,8368.83,7406.52,-0.1149873996724,2018-05-30,0.007751938,0.062015504,0.9302326,0.1315814,129,-390.73500275449805,-313.0895631280029,-77.64543962649515
436,2018-05-31,7406.15,7608.90,7361.13,7494.17,7494.17,5127130112,BTC,7985.308571,6933.048293477641,9037.568848522358,0.26662685958438465,17.5222906350290000000,7761.677333,-0.03446514477774671,1,154218446608,8094.32,7494.17,-0.0741445853389,2018-05-31,0.006849315,0.061643835,0.9315069,0.1207603,146,-376.5075677569239,-325.7731640537871,-50.73440370313676
437,2018-06-01,7500.70,7604.73,7407.34,7541.45,7541.45,4921460224,BTC,7942.449524,6894.919807314574,8989.979240685425,0.308597542574336,24.8821936308322500000,7724.819333,-0.02373768564614274,1,159139906832,8250.97,7541.45,-0.0859923136310,2018-06-01,0.008196721,0.1557377,0.8360656,0.040123,122,-357.29840851088284,-332.0782129452063,-25.220195565676534
438,2018-06-02,7536.72,7695.83,7497.26,7643.45,7643.45,4939299840,BTC,7901.428571,6879.242983794122,8923.614158205879,0.37381030693986833,27.9836414329902500000,7684.318000,-0.00531836397192308,1,164079206672,8247.18,7643.45,-0.0732044165400,2018-06-02,0.06310485,0.014602302,0.9146767,0.2611609,17463,-330.03996854876095,-331.67056406591723,1.63059551715628
439,2018-06-03,7632.09,7754.89,7613.04,7720.25,7720.25,4851760128,BTC,7853.633810,6901.515500807783,8805.752119192219,0.4299541828403845,33.6784630353020000000,7649.189333,0.00928996053129857,1,168930966800,8513.25,7720.25,-0.0931489149267,2018-06-03,0.05859149,0.015094935,0.918845,0.2456857,19013,-298.79600597389253,-325.0956524475123,26.29964647361976
440,2018-06-04,7722.53,7753.82,7474.04,7514.47,7514.47,4993169920,BTC,7796.380476,6920.731799155773,8672.029152844227,0.3390276354804851,34.5516883641767500000,7582.604000,-0.00898556749106244,-1,163937796880,8418.99,7514.47,-0.1074380656112,2018-06-04,0.05067583,0.014910121,0.92786473,0.2132621,21529,-287.3275338029962,-317.5420287186091,30.21449491561293
441,2018-06-05,7500.90,7643.23,7397.00,7633.76,7633.76,4961739776,BTC,7754.636667,6940.528606940811,8568.744727059187,0.42576128837785304,40.9303450786817500000,7530.255333,0.01374517362597378,1,168899536656,8041.78,7633.76,-0.0507375232846,2018-06-05,0.05518896,0.013377325,0.9255549,0.2101696,16670,-265.55186433801555,-307.1439958424904,41.59213150447488
442,2018-06-06,7625.97,7680.43,7502.01,7653.98,7653.98,4692259840,BTC,7720.596190,6956.0801147347065,8485.112265265294,0.45643244651403553,53.8833015815240000000,7504.402000,0.01993203455785018,1,173591796496,7557.82,7653.98,0.0127232455920,2018-06-06,0.0,0.07317073,0.9268293,0.1464472,123,-243.85193111801073,-294.4855828975945,50.63365177958377
443,2018-06-07,7650.82,7741.27,7650.82,7678.24,7678.24,4485799936,BTC,7700.782857,6955.624514628586,8445.941199371415,0.48487378069991155,66.4802510408345000000,7512.430000,0.02207142029942376,1,178077596432,7587.34,7678.24,0.0119804832787,2018-06-07,0.0,0.05925926,0.94074076,0.1074444,135,-222.1363488958641,-280.0157360972484,57.879387201384304
444,2018-06-08,7685.14,7698.19,7558.40,7624.92,7624.92,4227579904,BTC,7670.970952,6969.445426593981,8372.496477406017,0.4671779925802796,80.0262569683782500000,7514.935333,0.01463547750265119,-1,173850016528,7480.14,7624.92,0.0193552527092,2018-06-08,0.017857144,0.0625,0.91964287,0.1150714,112,-206.84469503069795,-265.3815278839383,58.536832853240355
445,2018-06-09,7632.52,7683.58,7531.98,7531.98,7531.98,3845220096,BTC,7636.913810,6985.203097536988,8288.624522463011,0.41949356670582916,83.2317803717522500000,7518.391333,0.00180739022460245,-1,170004796432,7355.88,7531.98,0.0239400316482,2018-06-09,0.024793388,0.08264463,0.892562,0.0317355,121,-199.92086713028675,-252.28939573320798,52.36852860292123
446,2018-06-10,7499.55,7499.55,6709.07,6786.02,6786.02,5804839936,BTC,7554.664762,6932.149477444865,8177.180046555136,-0.11737019240362259,61.0674186150000000000,7480.400667,-0.09282666770287854,-1,164199956496,7368.22,6786.02,-0.0790150131239,2018-06-10,0.008547009,0.11965812,0.8632479,-0.0406752,117,-251.7246957880252,-252.17645574417148,0.45175995614627595
447,2018-06-11,6799.29,6910.18,6706.63,6906.92,6906.92,4745269760,BTC,7482.661429,6934.707511839599,8030.615346160401,-0.025355701427958316,41.1002762862620000000,7449.647333,-0.07285275513591886,1,168945226256,7135.99,6906.92,-0.0321006615760,2018-06-11,0.0091743115,0.06422018,0.9266055,0.1146606,109,-279.7986390863907,-257.70089241261536,-22.09774667377536
448,2018-06-12,6905.82,6907.96,6542.08,6582.36,6582.36,4654380032,BTC,7413.165238,6797.085302971466,8029.245173028533,-0.17426740489569892,20.1793677866215000000,7412.738667,-0.11202049664811150,-1,164290846224,7472.59,6582.36,-0.1191327237276,2018-06-12,0.009090909,0.018181818,0.96363634,0.1306,110,-324.4961315385408,-271.05994023780045,-53.43619130074035
449,2018-06-13,6596.88,6631.66,6285.63,6349.90,6349.90,5052349952,BTC,7355.645238,6589.107458145176,8122.183017854824,-0.15603109489951036,3.2352846729392500000,7337.892667,-0.13464256181385761,-1,159238496272,7406.52,6349.90,-0.1426607907627,2018-06-13,0.028301887,0.056603774,0.9150943,0.1354245,106,-374.3613905077327,-291.7202302917869,-82.64116021594583
450,2018-06-14,6342.75,6707.14,6334.46,6675.35,6675.35,5138710016,BTC,7312.217143,6498.9012142947295,8125.53307170527,0.10847493543263213,9.1726364443845000000,7289.148000,-0.08420709800377218,1,164377206288,7494.17,6675.35,-0.1092609321646,2018-06-14,0.027272727,0.06363636,0.90909094,0.1368091,110,-383.2015633125693,-310.0164968959434,-73.18506641662589
451,2018-06-15,6674.08,6681.08,6433.87,6456.58,6456.58,3955389952,BTC,7263.476190,6373.370404770488,8153.581975229513,0.04674140793729179,7.8835698909037500000,7219.975333,-0.10573378686084771,-1,160421816336,7541.45,6456.58,-0.1438542985765,2018-06-15,0.03125,0.052083332,0.90625,0.0759792,96,-403.2123931361575,-328.6556761439863,-74.55671699217123
452,2018-06-16,6455.45,6592.49,6402.29,6550.16,6550.16,3194170112,BTC,7225.108571,6283.746843494877,8166.470298505123,0.14150413635956596,11.5370160907797500000,7153.889333,-0.08439176298339867,1,163615986448,7643.45,6550.16,-0.1430361943887,2018-06-16,0.0,0.1097561,0.8902439,-0.0362561,82,-406.83030945793143,-344.2906028067753,-62.53970665115611
453,2018-06-17,6545.53,6589.11,6499.27,6499.27,6499.27,3104019968,BTC,7183.730000,6193.657845942529,8173.80215405747,0.15433832413376386,14.2620498412815000000,7077.610667,-0.08171411147219014,-1,160511966480,7720.25,6499.27,-0.1581529095560,2018-06-17,0.023809524,0.14285715,0.8333333,-0.0199524,84,-409.0882175794577,-357.25012576131184,-51.83809181814587
454,2018-06-18,6510.07,6781.14,6446.68,6734.82,6734.82,4039200000,BTC,7164.626667,6155.390148886763,8173.863185113238,0.2870634587204978,15.5690782736997500000,7011.915333,-0.03951778078322099,1,164551166480,7514.47,6734.82,-0.1037531589054,2018-06-18,0.028846154,0.03846154,0.9230769,0.0663077,104,-387.404946534165,-363.2810899158825,-24.123856618282502
455,2018-06-19,6742.39,6822.50,6709.92,6769.94,6769.94,4057029888,BTC,7131.167143,6118.229083370629,8144.10520262937,0.3216933703072765,21.5282157108005000000,6962.280000,-0.02762600757223208,1,168608196368,7633.76,6769.94,-0.1131578671585,2018-06-19,0.0,0.03960396,0.96039605,0.0896337,101,-363.20016213646613,-363.26490435999926,0.06474222353313053
456,2018-06-20,6770.76,6821.56,6611.88,6776.55,6776.55,3888640000,BTC,7101.168571,6085.171180722136,8117.165961277864,0.3402463558930892,25.9045284581820000000,6905.132667,-0.01862131738822390,1,172496836368,7653.98,6776.55,-0.1146370907685,2018-06-20,0.08547009,0.042735044,0.8717949,0.0951709,117,-339.5699730825818,-358.5259181045158,18.955945021934042
457,2018-06-21,6780.09,6810.94,6715.17,6729.74,6729.74,3529129984,BTC,7064.767143,6053.141105174898,8076.393180825102,0.334411565898266,30.3282668593885000000,6843.516667,-0.01662546794817355,-1,168967706384,7678.24,6729.74,-0.1235309133343,2018-06-21,0.04761905,0.03968254,0.9126984,0.199619,126,-320.92067997104914,-351.0048704778225,30.084190506773382
458,2018-06-22,6737.88,6747.08,6006.60,6083.69,6083.69,5079810048,BTC,6995.350000,5922.873568389496,8067.826431610505,0.0749743429648197,23.0838866555250000000,6737.213333,-0.09700202453126030,-1,163887896336,7624.92,6083.69,-0.2021306453051,2018-06-22,0.008,0.064,0.928,0.095848,125,-354.1889468498075,-351.64168575221953,-2.5472610975879775
459,2018-06-23,6090.10,6224.82,6071.81,6162.48,6162.48,3431360000,BTC,6924.827619,5836.6892290715,8012.966008928499,0.14970098194490986,16.5385832984562500000,6639.717333,-0.07187615211088686,1,167319256336,7531.98,6162.48,-0.1818246994814,2018-06-23,0.022727273,0.07954545,0.89772725,0.0693864,88,-369.9322448676403,-355.2997975753037,-14.632447292336565
460,2018-06-24,6164.28,6223.78,5826.41,6173.23,6173.23,4566909952,BTC,6851.160000,5779.85586811214,7922.464131887859,0.18359591836664188,11.2279915341245000000,6549.134000,-0.05739751240393005,1,171886166288,6786.02,6173.23,-0.0903018264019,2018-06-24,0.03773585,0.06603774,0.8962264,0.0254057,106,-377.1934356808415,-359.67852519641133,-17.514910484430175
461,2018-06-25,6171.97,6327.37,6119.68,6249.18,6249.18,5500810240,BTC,6790.908095,5734.061242639279,7847.7549473607205,0.2437054887423282,9.1048501295950000000,6513.344667,-0.04055745250798655,1,177386976528,6906.92,6249.18,-0.0952291325222,2018-06-25,0.036363635,0.018181818,0.94545454,0.1878091,110,-372.5252126919713,-362.24786269552334,-10.277349996447981
462,2018-06-26,6253.55,6290.16,6093.67,6093.67,6093.67,3279759872,BTC,6717.570476,5693.127071892653,7742.013880107347,0.19549295085576843,9.4649517374235000000,6459.128000,-0.05658008325582029,-1,174107216656,6582.36,6093.67,-0.0742423689984,2018-06-26,0.025423728,0.050847456,0.9237288,0.116678,118,-377.02782758454305,-365.2038556733273,-11.823971911215722
463,2018-06-27,6084.40,6180.00,6052.85,6157.13,6157.13,3296219904,BTC,6646.291905,5689.426309158681,7603.157500841319,0.24439361853641167,10.7547855177847500000,6430.779333,-0.04255305909747969,1,177403436560,6349.90,6157.13,-0.0303579583930,2018-06-27,0.02970297,0.02970297,0.9405941,0.1072673,101,-371.1965677130893,-366.4023980812797,-4.794169631809552
464,2018-06-28,6153.16,6170.41,5873.05,5903.44,5903.44,3467800064,BTC,6561.777619,5676.918876670928,7446.636361329073,0.12799846602229215,8.0356183348590000000,6401.015333,-0.07773381363965559,-1,173935636496,6675.35,5903.44,-0.1156358842608,2018-06-28,0.046153847,0.1,0.85384613,0.0957077,130,-382.63513541820976,-369.6489455486658,-12.986189869543978
465,2018-06-29,5898.13,6261.66,5835.75,6218.30,6218.30,3966230016,BTC,6494.795714,5745.34764573719,7244.24378226281,0.31553377364698165,12.0254610102730000000,6370.545333,-0.02389832032296441,1,177901866512,6456.58,6218.30,-0.0369049868506,2018-06-29,0.0546875,0.0859375,0.859375,0.1184922,128,-362.1194248120428,-368.14304140134124,6.023616589298456
466,2018-06-30,6214.22,6465.51,6214.22,6404.00,6404.00,4543860224,BTC,6441.082381,5861.3812358258765,7020.783526174124,0.4680159498487261,25.9980322615345000000,6367.040000,0.00580489521033322,1,182445726736,6550.16,6404.00,-0.0223139587430,2018-06-30,0.026548672,0.07079646,0.8938053,0.1468673,113,-327.10547006576326,-359.93552713422565,32.830057068462395
467,2018-07-01,6411.68,6432.85,6289.29,6385.82,6385.82,4788259840,BTC,6422.025238,5864.044523328998,6980.005952671002,0.46755690918336856,37.1602661749380000000,6356.084000,0.00467835226847222,-1,177657466896,6499.27,6385.82,-0.0174558065752,2018-07-01,0.031914894,0.04255319,0.89361703,0.0819468,94,-297.3954431840266,-347.42751034418586,50.03206716015927
468,2018-07-02,6380.38,6683.86,6305.70,6614.18,6614.18,4396930048,BTC,6408.085238,5887.617733438225,6928.552742561775,0.6979900379885666,57.5110810779857500000,6363.744667,0.03935345399677394,1,182054396944,6734.82,6614.18,-0.0179128766619,2018-07-02,0.10569106,0.032520324,0.8455285,0.1242033,123,-252.51248259937165,-328.44450479522305,75.9320221958514
469,2018-07-03,6596.66,6671.37,6447.75,6529.59,6529.59,4672309760,BTC,6405.572381,5888.138089986938,6923.006672013062,0.6198390028975386,66.4243337036572500000,6350.062667,0.02827174193618080,-1,177382087184,6769.94,6529.59,-0.0355025303031,2018-07-03,0.024590164,0.024590164,0.9508197,0.1657705,122,-221.2180549891791,-306.9992148340143,85.7811598448352
470,2018-07-04,6550.87,6771.92,6450.46,6597.55,6597.55,4176689920,BTC,6417.365238,5894.005568418209,6940.724907581792,0.6721423835963352,71.9663043602755000000,6338.570000,0.04085779600130629,1,181558777104,6776.55,6597.55,-0.0264146210092,2018-07-04,0.04901961,0.029411765,0.92156863,0.1392451,102,-188.75731478188573,-283.3508348235886,94.5935200417029
471,2018-07-05,6599.71,6749.54,6546.65,6639.14,6639.14,4999240192,BTC,6415.640952,5895.623223459722,6935.658680540278,0.7148956042588935,80.4130492860932500000,6329.409333,0.04893516135623267,1,186558017296,6729.74,6639.14,-0.0134626300570,2018-07-05,0.05,0.05,0.9,0.10361,100,-157.85630960771778,-258.25192978041446,100.39562017269668
472,2018-07-06,6638.69,6700.94,6533.55,6673.50,6673.50,4313959936,BTC,6425.970476,5894.055672202392,6957.885279797609,0.7326777918500871,85.0622343830455000000,6325.660000,0.05498872844888913,1,190871977232,6083.69,6673.50,0.0969493843375,2018-07-06,0.045454547,0.1,0.8545455,0.1276545,110,-129.106219404508,-232.42278770523316,103.31656830072515
473,2018-07-07,6668.71,6863.99,6579.24,6856.93,6856.93,3961080064,BTC,6440.578571,5878.352897367579,7002.804244632421,0.8702707369356171,92.1335083347812500000,6377.209333,0.07522423084304296,1,194833057296,6162.48,6856.93,0.1126900209007,2018-07-07,0.048076924,0.09615385,0.8557692,0.0981058,104,-90.47733141732624,-204.03369644765178,113.55636503032554
474,2018-07-08,6857.80,6885.91,6747.98,6773.88,6773.88,3386210048,BTC,6453.655238,5873.217004331023,7034.093471668977,0.7758474058263223,95.0813380489967500000,6417.969333,0.05545533930334846,-1,191446847248,6173.23,6773.88,0.0972991448561,2018-07-08,0.058252428,0.097087376,0.8446602,0.1197184,103,-65.80652366192953,-176.38826189050735,110.58173822857782
475,2018-07-09,6775.08,6838.68,6724.34,6741.75,6741.75,3718129920,BTC,6453.985238,5872.868141861225,7035.102334138775,0.7475961935314319,94.8025149713160000000,6455.870667,0.04428207251135132,-1,187728717328,6249.18,6741.75,0.0788215413862,2018-07-09,0.03,0.04,0.93,0.10084,100,-48.29068825628201,-150.76874716366228,102.47805890738027
476,2018-07-10,6739.21,6767.74,6320.72,6329.95,6329.95,4052430080,BTC,6433.033333,5868.263628205795,6997.803037794206,0.40873861316838633,80.9853800249610000000,6461.255333,-0.02032195389793304,-1,183676287248,6093.67,6329.95,0.0387746628879,2018-07-10,0.02970297,0.10891089,0.8613861,0.0244455,101,-66.86727660506222,-133.98845305194226,67.12117644688004
477,2018-07-11,6330.77,6444.96,6330.47,6394.71,6394.71,3644859904,BTC,6414.850476,5872.384600078713,6957.316351921286,0.48143618161622204,68.8662177893842500000,6481.324667,-0.01336372909090684,1,187321147152,6157.13,6394.71,0.0385861594607,2018-07-11,0.010638298,0.07446808,0.9148936,-0.0015,94,-75.49352358367923,-122.28946715828965,46.79594357461042
478,2018-07-12,6396.78,6397.10,6136.42,6228.81,6228.81,3770170112,BTC,6390.996667,5862.820050617436,6919.1732833825645,0.3464654985004804,54.5747726772172500000,6486.103333,-0.03966839869647818,-1,183550977040,5903.44,6228.81,0.0551153225916,2018-07-12,0.048275862,0.03448276,0.9172414,0.2229034,145,-94.62584217280983,-116.75674216119369,22.13089998838386
479,2018-07-13,6235.03,6310.55,6192.24,6238.05,6238.05,3805400064,BTC,6398.347143,5884.017799791084,6912.676486208916,0.34416877520549266,33.3678703123027500000,6508.410667,-0.04154019788130865,1,187356377104,6218.30,6238.05,0.0031761092260,2018-07-13,0.061946902,0.061946902,0.8761062,0.1501327,113,-107.80009927628362,-114.96541358421167,7.165314307928057
480,2018-07-14,6247.50,6298.19,6212.22,6276.12,6276.12,2923670016,BTC,6403.758571,5897.524518992997,6909.992623007003,0.37393324244589266,24.0680053223397500000,6512.265333,-0.03626162647325906,1,190280047120,6404.00,6276.12,-0.0199687695191,2018-07-14,0.04901961,0.04901961,0.89215684,0.084598,102,-113.85639644537241,-114.74361015644382,0.8872137110714107
481,2018-07-15,6272.70,6403.46,6256.51,6359.64,6359.64,3285459968,BTC,6412.635238,5916.951285521444,6908.319190478555,0.44654331884761567,16.3943731874140000000,6509.308000,-0.02299292029198803,1,193565507088,6385.82,6359.64,-0.0040997084165,2018-07-15,0.052083332,0.104166664,0.8333333,0.0753333,96,-110.6412857209225,-113.92314526933956,3.28185954841706
482,2018-07-16,6357.01,6741.75,6357.01,6741.75,6741.75,4725799936,BTC,6436.090952,5926.471832621429,6945.71007137857,0.7998896983817256,28.2790299706315000000,6533.036667,0.03194736898604338,1,198291307024,6614.18,6741.75,0.0192873493010,2018-07-16,0.18367347,0.06122449,0.75510204,0.1661224,147,-76.37974557246798,-106.41446532996524,30.034719757497257
483,2018-07-17,6739.65,7387.24,6684.17,7321.04,7321.04,5961950208,BTC,6494.537143,5879.280149276471,7109.794136723528,1.1716728663237246,52.5058905941537500000,6580.160667,0.11259289407864545,1,204253257232,6529.59,7321.04,0.1212097543644,2018-07-17,0.16071428,0.05357143,0.78571427,0.1137857,168,-2.455066019433616,-85.62258546785893,83.16751944842531
484,2018-07-18,7315.32,7534.99,7280.47,7370.78,7370.78,6103410176,BTC,6552.330000,5848.551127739685,7256.1088722603145,1.081468151616571,75.6228905304717500000,6636.240000,0.11068617168758212,1,210356667408,6597.55,7370.78,0.1171995665057,2018-07-18,0.1118421,0.07236842,0.80921054,0.1564145,152,59.45897141977457,-56.60627409033222,116.06524551010679
485,2018-07-19,7378.20,7494.46,7295.46,7466.86,7466.86,5111629824,BTC,6626.778571,5881.736826067927,7371.820315932073,1.0637814489687365,95.4156849009742500000,6694.194000,0.11542330562872842,1,215468297232,6639.14,7466.86,0.1246727738834,2018-07-19,0.07079646,0.053097345,0.8761062,0.0704425,113,114.95402671921329,-22.29421392842311,137.2482406476364
486,2018-07-20,7467.40,7594.67,7323.26,7354.13,7354.13,4936869888,BTC,6680.865714,5896.494938624694,7465.236489375305,0.9291747647519488,97.7236379790800000000,6741.860000,0.09081618425775676,-1,210531427344,6673.50,7354.13,0.1019899602907,2018-07-20,0.069565214,0.060869563,0.8608696,0.1562348,115,148.13033469775564,11.790695796812653,136.339638900943
487,2018-07-21,7352.72,7437.64,7262.41,7419.29,7419.29,3726609920,BTC,6729.212857,5893.06490386867,7565.360810131331,0.9126525338103719,96.7630548039255000000,6791.579333,0.09242484497677589,1,214258037264,6856.93,7419.29,0.0820133791653,2018-07-21,0.14035088,0.096491225,0.7631579,0.1356404,114,177.63302231971738,44.95916110139361,132.67386121832376
488,2018-07-22,7417.80,7537.95,7383.82,7418.49,7418.49,3695460096,BTC,6778.387619,5906.364681046995,7650.410556953005,0.8670215272677244,95.7863171923590000000,6829.016667,0.08631891848331903,1,217953497360,6773.88,7418.49,0.0951611188861,2018-07-22,0.12686567,0.104477614,0.76865673,0.1029552,134,198.65953800849366,75.69923648281363,122.96030152568002
489,2018-07-23,7414.71,7771.50,7409.10,7711.11,7711.11,5132480000,BTC,6830.622381,5872.725826879363,7788.518935120637,0.959594313818312,95.7863171923590000000,6891.498667,0.11893078307113601,1,223085977360,6741.75,7711.11,0.1437846256536,2018-07-23,0.11392405,0.044303797,0.84177214,0.1958987,158,236.21228348535897,107.80184588332271,128.41043760203627
490,2018-07-24,7716.51,8424.27,7705.50,8424.27,8424.27,7277689856,BTC,6920.845238,5749.010963170678,8092.6795128293215,1.141483524715547,98.0626792132790000000,7003.666667,0.20283708527900447,1,230363667216,6329.95,8424.27,0.3308588535454,2018-07-24,0.067073174,0.0121951215,0.9207317,0.1925427,164,319.8323287052908,150.20794244771636,169.62438625757446
491,2018-07-25,8379.66,8416.87,8086.36,8181.39,8181.39,5845400064,BTC,6996.266190,5713.2247718926,8279.307608107401,0.961841602801943,96.2575549740420000000,7127.096000,0.14792757106120080,-1,224518267152,6394.71,8181.39,0.2793996913073,2018-07-25,0.06875,0.0,0.93125,0.2072938,160,362.3267535504765,192.6317046682684,169.69504888220808
492,2018-07-26,8176.85,8290.33,7878.71,7951.58,7951.58,4899089920,BTC,7058.763333,5722.048104429108,8395.478561570892,0.8339591888821853,91.8517076148050000000,7230.887333,0.09966863454101063,-1,219619177232,6228.81,7951.58,0.2765809199510,2018-07-26,0.08108108,0.013513514,0.9054054,0.1789797,148,373.1586048844483,228.73708471150442,144.4215201729439
493,2018-07-27,7950.40,8262.66,7839.76,8165.01,8165.01,5195879936,BTC,7129.787619,5722.417132555087,8537.158105444913,0.8677860204440635,88.8870014095740000000,7359.967333,0.10938128263021191,1,224815057168,6238.05,8165.01,0.3089042248780,2018-07-27,0.11034483,0.0068965517,0.8827586,0.1904552,145,394.4183333667979,261.87333444256313,132.5449989242348
494,2018-07-28,8169.06,8222.85,8110.77,8192.15,8192.15,3988750080,BTC,7193.369524,5718.735661110961,8668.003386889039,0.8386537164022642,86.1856071866380000000,7490.240667,0.09370985048483490,1,228803807248,6276.12,8192.15,0.3052889364767,2018-07-28,0.17272727,0.0,0.8272727,0.1854091,110,408.7450342191605,291.24767439788263,117.49735982127788
495,2018-07-29,8205.82,8272.26,8141.18,8218.46,8218.46,4107190016,BTC,7262.159048,5735.843733172756,8788.474362827244,0.8132710989368005,86.4592215867847500000,7619.730000,0.07857627501236920,1,232910997264,6359.64,8218.46,0.2922838399658,2018-07-29,0.2037037,0.0,0.7962963,0.1729537,108,417.4103977448667,316.48021906727945,100.93017867758726
496,2018-07-30,8221.58,8235.50,7917.50,8180.48,8180.48,5551400000,BTC,7330.670000,5773.614366209094,8887.725633790906,0.7728900565778111,88.2194127673212500000,7741.119333,0.05675673608686378,-1,227359597264,6741.75,8180.48,0.2134060147588,2018-07-30,0.071428575,0.007936508,0.9206349,0.1455476,126,416.41294298301455,336.4667638504265,79.94617913258804
497,2018-07-31,8181.20,8181.53,7696.93,7780.44,7780.44,5287530000,BTC,7399.740952,5901.556915081909,8897.92498891809,0.6270534989757115,76.5944595180415000000,7810.365333,-0.00383148953014539,-1,222072067264,7321.04,7780.44,0.0627506474490,2018-07-31,0.06283521,0.007183979,0.9203858,0.2251007,20323,378.97399189628595,344.9682094595984,34.005782436687525
498,2018-08-01,7769.04,7769.04,7504.95,7624.91,7624.91,4797620000,BTC,7458.321905,6030.6437452228165,8886.000064777183,0.5583423140079412,60.6216615792042500000,7830.623333,-0.02627036498270552,-1,217274447264,7370.78,7624.91,0.0344780335324,2018-08-01,0.06175677,0.0055960827,0.9231538,0.2394594,20014,332.9157368637061,342.55771494042,-9.641978076713883
499,2018-08-02,7634.19,7712.77,7523.44,7567.15,7567.15,4214110000,BTC,7522.052381,6210.093873700251,8834.01088829975,0.5171871361590613,43.0902062726685000000,7843.714667,-0.03525939924402913,-1,213060337264,7466.86,7567.15,0.0134313486526,2018-08-02,0.059422493,0.006940223,0.9239615,0.2318935,19740,288.4286625576833,331.7319044638727,-43.303241906189385
500,2018-08-03,7562.14,7562.14,7328.65,7434.39,7434.39,4627150000,BTC,7579.020952,6404.538561976126,8753.503342023872,0.43842779030639223,23.5875883822207500000,7841.550000,-0.05192340799969394,-1,208433187264,7354.13,7434.39,0.0109135954899,2018-08-03,0.051485147,0.0055445544,0.9342008,0.2243855,17675,239.69663952524115,313.3248514761464,-73.62821195090527
501,2018-08-04,7438.67,7497.49,6984.07,7032.85,7032.85,4268390000,BTC,7615.055714,6569.06071836051,8661.05070963949,0.22169765800645327,13.1772478367315000000,7820.131333,-0.10067367151210988,-1,204164797264,7419.29,7032.85,-0.0520858464894,2018-08-04,0.13934426,0.0,0.8606557,0.1241885,122,166.75301305224184,284.0104837913655,-117.25747073912368
502,2018-08-05,7031.08,7102.77,6940.70,7068.48,7068.48,3679110000,BTC,7648.810000,6735.6530953664105,8561.966904633591,0.18223971310118814,7.4916133465952500000,7796.744000,-0.09340617057581986,1,207843907264,7418.49,7068.48,-0.0471807605052,2018-08-05,0.14285715,0.0,0.85714287,0.1905397,126,110.54540811696006,249.31746865648444,-138.77206053952438
503,2018-08-06,7062.94,7166.55,6890.54,6951.80,6951.80,3925900000,BTC,7658.812381,6783.570499143224,8534.054262856776,0.09610457654282198,2.5151616673757500000,7765.631333,-0.10479912039367991,-1,203918007264,7711.11,6951.80,-0.0984696107305,2018-08-06,0.08496732,0.006535948,0.90849674,0.183183,153,55.940527804510566,210.6420804860897,-154.70155268157913
504,2018-08-07,6958.32,7146.56,6748.24,6753.12,6753.12,4682800000,BTC,7631.768571,6680.866731054661,8582.670410945339,0.037991970311831845,0.6401733480905000000,7701.765333,-0.12317245358480465,-1,199235207264,8424.27,6753.12,-0.1983732715120,2018-08-07,0.115384616,0.0,0.88461536,0.1820462,130,-3.327689281363746,167.84812653259903,-171.17581581396277
505,2018-08-08,6746.85,6746.85,6226.22,6305.80,6305.80,5064430000,BTC,7581.055238,6471.357938884263,8690.752537115737,-0.07459599073377372,0.6401733480905000000,7560.534000,-0.16595838336286828,-1,194170777264,8181.39,6305.80,-0.2292507752350,2018-08-08,0.07638889,0.0069444445,0.9166667,0.2096319,144,-85.40862643660603,117.19677593875801,-202.60540237536404
506,2018-08-09,6305.56,6625.73,6249.07,6568.23,6568.23,4267040000,BTC,7538.263333,6343.988590784737,8732.538075215263,0.09388183526318084,3.4301705478235000000,7452.990000,-0.11871208736359501,1,198437817264,7951.58,6568.23,-0.1739717137978,2018-08-09,0.074324325,0.02027027,0.9054054,0.2103041,148,-127.80914840796049,68.1955910694143,-196.0047394773748
507,2018-08-10,6571.42,6591.26,6124.52,6184.71,6184.71,4528680000,BTC,7482.576667,6151.07065954328,8814.08267445672,0.012632064845495335,3.4301705478235000000,7335.198667,-0.15684492257529199,-1,193909137264,8165.01,6184.71,-0.2425349142255,2018-08-10,0.10204082,0.006802721,0.88435376,0.2374286,147,-190.16660410166514,16.5231520351984,-206.68975613686354
508,2018-08-11,6185.79,6455.74,6109.03,6295.73,6295.73,4047850000,BTC,7429.073810,6000.156221243026,8857.991398756973,0.10342576124844796,4.7948908920152500000,7210.580000,-0.12687606267456987,1,197956987264,8192.15,6295.73,-0.2314923432798,2018-08-11,0.124087594,0.01459854,0.8613139,0.2016058,137,-227.998723473067,-32.381223066454695,-195.6175004066123
509,2018-08-12,6283.65,6409.85,6237.50,6322.69,6322.69,5665250000,BTC,7376.892857,5868.52813939165,8885.25757460835,0.1505477605338265,6.4910187346705000000,7085.949333,-0.10771447792399844,1,203622237264,8218.46,6322.69,-0.2306721697252,2018-08-12,0.091603056,0.0,0.90839696,0.1339237,131,-252.89034151649503,-76.48304675646278,-176.40729476003224
510,2018-08-13,6341.36,6537.05,6225.72,6297.57,6297.57,4083980000,BTC,7309.581429,5738.982184045568,8880.180673954432,0.17782633531402156,4.4745882470745000000,6957.890000,-0.09490233389720159,-1,199538257264,8180.48,6297.57,-0.2301710902050,2018-08-13,0.080882356,0.014705882,0.89705884,0.1029412,136,-271.51425489506073,-115.48928838418239,-156.02496651087836
511,2018-08-14,6287.66,6287.94,5971.05,6199.71,6199.71,5301700000,BTC,7203.650000,5648.816047502178,8758.483952497822,0.17715523629157243,4.7095904090945000000,6825.838667,-0.09172919219832478,-1,194236557264,7780.44,6199.71,-0.2031671730648,2018-08-14,0.04605263,0.0,0.95394737,0.2049474,152,-290.81795620425146,-150.5550219481962,-140.26293425605525
512,2018-08-15,6221.42,6588.49,6221.42,6308.52,6308.52,4895450000,BTC,7114.465714,5580.464753419187,8648.466674580814,0.2373059943538602,5.4940507342542500000,6727.710667,-0.06230806997336647,1,199132007264,7624.91,6308.52,-0.1726433492330,2018-08-15,0.06097561,0.0060975607,0.9268293,0.2301829,164,-293.94777396838435,-179.23357235223386,-114.71420161615049
513,2018-08-16,6294.23,6473.50,6276.41,6334.73,6334.73,4328420000,BTC,7037.472857,5517.70074967413,8557.24496432587,0.26879992282641696,6.5108796926175000000,6641.698667,-0.04621839718884073,1,203460427264,7567.15,6334.73,-0.1628644866297,2018-08-16,0.103174604,0.0,0.8968254,0.2412381,126,-290.95925200047077,-201.57870828188126,-89.38054371858951
514,2018-08-17,6340.91,6582.50,6324.97,6580.63,6580.63,4992990000,BTC,6962.026190,5522.139702189572,8401.912677810427,0.36756032741859673,13.0175672618632500000,6575.930667,0.00071462629975445,1,208453417264,7434.39,6580.63,-0.1148392806942,2018-08-17,0.09558824,0.014705882,0.88235295,0.2576544,136,-265.68608804269934,-214.40018423404487,-51.28590380865447
515,2018-08-18,6583.43,6617.35,6353.73,6423.76,6423.76,3984520000,BTC,6877.817143,5536.625362811306,8219.008923188694,0.33072624299258746,19.5447883027127500000,6508.555333,-0.01302828794741384,-1,204468897264,7032.85,6423.76,-0.0866064255601,2018-08-18,0.05,0.025,0.925,0.236675,80,-255.3712605767214,-222.5943995025802,-32.77686107414121
516,2018-08-19,6422.57,6537.98,6361.55,6506.07,6506.07,3311170000,BTC,6796.274762,5596.673389349586,7995.876134650414,0.3790411679177983,26.4862081289652500000,6473.436667,0.00504111412201756,1,207780067264,7068.48,6506.07,-0.0795659038435,2018-08-19,0.023529412,0.011764706,0.9529412,0.0237176,85,-237.8135893646113,-225.63823747498645,-12.175351889624835
517,2018-08-20,6500.51,6536.92,6297.93,6308.53,6308.53,3665100000,BTC,6707.134286,5672.704823589509,7741.563748410492,0.30733133554068137,27.8086317917775000000,6422.773333,-0.01778722789624561,-1,204114967264,6951.80,6308.53,-0.0925328691850,2018-08-20,0.052083332,0.0,0.9375,0.1264063,96,-237.10562941934404,-227.93171586385796,-9.173913555486081
518,2018-08-21,6301.07,6500.87,6298.24,6488.76,6488.76,3377180000,BTC,6645.625714,5732.775852925981,7558.475575074019,0.4140791269796337,33.2610336339885000000,6391.904000,0.01515291844182891,1,207492147264,6753.12,6488.76,-0.0391463501315,2018-08-21,0.0,0.01724138,0.98275864,0.1552586,116,-219.47157955431157,-226.23968860194873,6.768109047637154
519,2018-08-22,6486.25,6816.79,6310.11,6376.71,6376.71,4668110000,BTC,6586.187619,5785.487717291382,7386.8875207086185,0.36919092998950376,38.6224717768455000000,6366.810000,0.00155493881551358,-1,202824037264,6305.80,6376.71,0.0112452028291,2018-08-22,0.04918033,0.0,0.9508197,0.1725656,122,-212.09308943721499,-223.41036876900196,11.317279331786978
520,2018-08-23,6371.34,6546.54,6371.34,6534.88,6534.88,3426180000,BTC,6537.031905,5874.430218807788,7199.6335911922115,0.4983761699940985,51.6430301012052500000,6382.082000,0.02394171682532440,1,206250217264,6568.23,6534.88,-0.0050774714040,2018-08-23,0.032258064,0.010752688,0.9569892,0.2214946,93,-191.27765599006398,-216.98382621321437,25.706170223150394
521,2018-08-24,6551.52,6719.96,6498.64,6719.96,6719.96,4097820000,BTC,6503.011429,5974.029224978514,7031.993633021486,0.7050622585700331,72.6076496373745000000,6392.197333,0.05127543001651573,1,210348037264,6184.71,6719.96,0.0865440740148,2018-08-24,0.04347826,0.026086956,0.93043476,0.3078174,115,-158.02524908998748,-205.192110788569,47.16686169858153
522,2018-08-25,6719.95,6789.63,6700.96,6763.19,6763.19,3312600000,BTC,6490.170476,6003.834759257906,6976.506192742095,0.7806903899932797,84.2348201656902500000,6430.762667,0.05169329832461068,1,213660637264,6295.73,6763.19,0.0742503252204,2018-08-25,0.078947365,0.065789476,0.8552632,0.20675,76,-126.7233889934596,-189.49836642954716,62.77497743608757
523,2018-08-26,6754.64,6774.75,6620.75,6707.26,6707.26,3295500000,BTC,6472.969524,6051.28604675783,6894.65300124217,0.7778037184813015,94.6297042874160000000,6458.198000,0.03856524683820471,-1,210365137264,6322.69,6707.26,0.0608237949354,2018-08-26,0.15789473,0.039473683,0.80263156,0.2389474,76,-105.21665086662506,-172.64202331696276,67.4253724503377
524,2018-08-27,6710.80,6884.64,6689.71,6884.64,6884.64,4019000000,BTC,6469.771429,6062.570263270543,6876.972594729457,1.0094147634091466,97.5185454674522500000,6495.661333,0.05988284287911782,1,214384137264,6297.57,6884.64,0.0932216712160,2018-08-27,0.0877193,0.01754386,0.8947368,0.232307,114,-73.01762070039695,-152.7171427936496,79.69952209325265
525,2018-08-28,6891.08,7109.56,6882.34,7096.28,7096.28,4659940000,BTC,6486.112381,6009.523887059798,6962.700874940202,1.1401409462862084,97.5185454674522500000,6548.908667,0.08358206852970912,1,219044077264,6199.71,7096.28,0.1446148287581,2018-08-28,0.08527132,0.023255814,0.8914729,0.2940155,129,-30.075387713177406,-128.18879177755517,98.11340406437776
526,2018-08-29,7091.71,7113.30,6970.82,7047.16,7047.16,4145880000,BTC,6521.415238,5993.822077937474,7049.008398062525,0.9982482732885448,95.9596950561595000000,6605.405333,0.06687775310215017,-1,214898197264,6308.52,7047.16,0.1170860994338,2018-08-29,0.07874016,0.007874016,0.9133858,0.2938898,127,-0.006853176601907762,-102.55240405736451,102.5455508807626
527,2018-08-30,7043.76,7072.69,6834.69,6978.23,6978.23,4463250000,BTC,6540.939048,5976.978755855073,7104.899340144927,0.887696579077259,94.6947198838517500000,6650.052667,0.04934958404593339,-1,210434947264,6334.73,6978.23,0.1015828614637,2018-08-30,0.073529415,0.04411765,0.875,0.2399706,136,18.05250411759971,-78.43142242237167,96.48392653997138
528,2018-08-31,6973.97,7057.17,6920.16,7037.58,7037.58,4495650000,BTC,6581.551905,6002.695848743558,7160.407961256443,0.8939045727094992,92.8318192173967500000,6696.909333,0.05086983413696457,1,214930597264,6580.63,7037.58,0.0694386403733,2018-08-31,0.07692308,0.094017096,0.82905984,0.2022735,117,36.730319614564905,-55.39907401498435,92.12939362954926
529,2018-09-01,7044.81,7242.29,7038.05,7193.25,7193.25,4116050000,BTC,6624.290952,6003.083592452327,7245.498311547673,0.9579461586017609,92.8318192173967500000,6737.750667,0.06760406484480557,1,219046647264,6423.76,7193.25,0.1197880991818,2018-09-01,0.1010101,0.14141414,0.75757575,0.2358283,99,63.36347626187944,-31.646563959611587,95.01004022149102
530,2018-09-02,7189.58,7306.31,7132.16,7272.72,7272.72,4329540000,BTC,6669.530476,6003.796128336424,7335.264823663576,0.9530256896890783,94.3906696286895000000,6794.348000,0.07040734445748142,1,223376187264,6506.07,7272.72,0.1178361130452,2018-09-02,0.08108108,0.13513513,0.7837838,0.1195225,111,89.84730581448366,-7.3477900047925315,97.19509581927619
531,2018-09-03,7279.03,7317.94,7208.15,7260.06,7260.06,4087760000,BTC,6715.363333,6025.107153851031,7405.619512148969,0.8945612393296993,97.8088445289940000000,6844.614000,0.06069677559611104,-1,219288427264,6308.53,7260.06,0.1508322858098,2018-09-03,0.0927835,0.05154639,0.8556701,0.2702268,97,108.5629294717719,15.834353890520362,92.72857558125153
532,2018-09-04,7263.00,7388.26,7255.44,7361.66,7361.66,4273640000,BTC,6770.694286,6067.874652621095,7473.513919378905,0.9204248756959512,99.6717451954490000000,6914.822667,0.06462021580574541,1,223562067264,6488.76,7361.66,0.1345249323445,2018-09-04,0.094339624,0.047169812,0.8584906,0.2426981,106,130.0938263033031,38.68624837307692,91.40757793022618
533,2018-09-05,7361.46,7388.43,6792.83,6792.83,6792.83,5800460000,BTC,6793.756667,6123.608509788975,7463.904824211024,0.4993086103497947,85.2337026552185000000,6935.094000,-0.02051363687355932,-1,217761607264,6376.71,6792.83,0.0652562214684,2018-09-05,0.088435374,0.034013607,0.8707483,0.2312449,147,100.1034597034677,50.96969063915508,49.133769064312624
534,2018-09-06,6755.14,6755.14,6404.72,6529.17,6529.17,5523470000,BTC,6803.015714,6154.479969832529,7451.5514581674715,0.28887384661308285,60.2337026552185000000,6945.258000,-0.05990965346427735,-1,212238137264,6534.88,6529.17,-0.0008737727395,2018-09-06,0.08264463,0.024793388,0.88429755,0.2911074,121,54.43324701466736,51.662401914257536,2.7708451004098222
535,2018-09-07,6528.92,6555.29,6396.87,6467.07,6467.07,4264680000,BTC,6797.608095,6139.4617457548175,7455.754444245182,0.24888708614802094,35.5619574597695000000,6940.737333,-0.06824452652140150,-1,207973457264,6719.96,6467.07,-0.0376326644801,2018-09-07,0.09803922,0.068627454,0.8333333,0.2585,102,13.077573289656357,43.94543618933731,-30.86786289968095
536,2018-09-08,6460.17,6534.25,6197.52,6225.98,6225.98,3835060000,BTC,6788.190000,6102.490845093126,7473.889154906873,0.09004616239000965,10.5619574597695000000,6907.805333,-0.09870361136883531,-1,204138397264,6763.19,6225.98,-0.0794314517262,2018-09-08,0.116071425,0.071428575,0.8125,0.2269286,112,-38.70487846970718,27.415373257528408,-66.1202517272356
537,2018-09-09,6223.38,6446.26,6201.22,6300.86,6300.86,3671890000,BTC,6778.418095,6070.348861503189,7486.487328496811,0.16277443475296027,1.6483516483517500000,6876.983333,-0.08377558954307851,1,207810287264,6707.26,6300.86,-0.0605910610294,2018-09-09,0.06666667,0.125,0.80833334,0.207575,120,-72.86076086271623,7.360146433479474,-80.2209072961957
538,2018-09-10,6301.57,6374.98,6292.76,6329.70,6329.70,3714100000,BTC,6779.426190,6074.111797307602,7484.740582692399,0.18118742885476977,3.9315652296422500000,6851.812667,-0.07620066285738107,1,211524387264,6884.64,6329.70,-0.0806055218574,2018-09-10,0.07317073,0.08943089,0.83739835,0.2063415,123,-96.49011873914424,-13.409906601045275,-83.08021213809896
539,2018-09-11,6331.88,6398.92,6260.21,6321.20,6321.20,3849910000,BTC,6771.447143,6048.745350996054,7494.1489350039465,0.18849728340126903,6.0276662440125000000,6814.250000,-0.07235572513482775,-1,207674477264,7096.28,6321.20,-0.1092234241039,2018-09-11,0.083333336,0.074074075,0.8425926,0.2775833,108,-114.58160859971758,-33.64424700077974,-80.93736159893784
540,2018-09-12,6317.01,6363.87,6265.09,6351.80,6351.80,4064230000,BTC,6770.260952,6044.761652843762,7495.760251156237,0.2116048544177276,8.7973724992957500000,6764.618000,-0.06102606237336683,1,211738707264,7047.16,6351.80,-0.0986723729843,2018-09-12,0.056737587,0.09219858,0.85106385,0.2184539,141,-125.0090538340728,-51.91720836743836,-73.09184546663444
541,2018-09-13,6354.24,6535.41,6354.24,6517.31,6517.31,4210910000,BTC,6769.424286,6042.745339461119,7496.1032325388815,0.3265297988879394,13.5621389828122500000,6729.294667,-0.03150176615679475,1,215949617264,6978.23,6517.31,-0.0660511333103,2018-09-13,0.08148148,0.05925926,0.8518519,0.2899185,135,-118.55102313353655,-65.243971320658,-53.30705181287854
542,2018-09-14,6515.41,6596.10,6456.17,6512.71,6512.71,4076220000,BTC,6759.555238,6024.47407166205,7494.63640433795,0.332096611024779,17.5907826148212500000,6698.260000,-0.02770122389993819,-1,211873397264,7037.58,6512.71,-0.0745810349580,2018-09-14,0.084745765,0.06779661,0.84745765,0.2406271,118,-112.50725522703578,-74.69662810193357,-37.810627125102215
543,2018-09-15,6509.40,6561.72,6493.55,6543.20,6543.20,3216300000,BTC,6749.079524,6007.9704320715255,7490.188615928474,0.36110039247779885,22.4777225979150000000,6665.301333,-0.01831895167221842,1,215089697264,7193.25,6543.20,-0.0903694435756,2018-09-15,0.08163265,0.091836736,0.82653064,0.2204184,98,-104.05772475639242,-80.56884743282535,-23.488877323567067
544,2018-09-16,6536.68,6544.33,6460.10,6517.18,6517.18,3273730000,BTC,6740.028095,5992.161602673486,7487.894587326513,0.35101077713299567,26.1182727528882500000,6620.230000,-0.01556592444673372,-1,211815967264,7272.72,6517.18,-0.1038868538869,2018-09-16,0.10091743,0.08256881,0.8165138,0.2407798,109,-98.32754874940565,-84.12058769614141,-14.206961053264237
545,2018-09-17,6514.06,6540.21,6257.52,6281.20,6281.20,3910780000,BTC,6711.292857,5940.7356459340635,7481.850068065937,0.22092087983639844,20.9207259087067500000,6554.128667,-0.04164225038397465,-1,207905187264,7260.06,6281.20,-0.1348280868202,2018-09-17,0.017857144,0.071428575,0.91071427,0.2244911,112,-111.54216813140283,-89.6049037831937,-21.937264348209126
546,2018-09-18,6280.91,6384.18,6265.71,6371.30,6371.30,4180090000,BTC,6676.770000,5913.73084774109,7439.809152258911,0.2998333381087438,17.8078331924487500000,6494.878000,-0.01902699327069731,1,212085277264,7361.66,6371.30,-0.1345294403708,2018-09-18,0.03305785,0.024793388,0.94214875,0.2747025,121,-113.43690219842028,-94.37130346623903,-19.065598732181257
547,2018-09-19,6371.85,6448.46,6208.34,6398.54,6398.54,4431340000,BTC,6645.883333,5893.376427986275,7398.390238013724,0.33565377848892386,18.4352711576732500000,6430.670000,-0.00499636896310960,1,216516617264,6792.83,6398.54,-0.0580450268886,2018-09-19,0.055555556,0.007936508,0.93650794,0.3376032,126,-111.45566077288186,-97.78817492756761,-13.667485845314246
548,2018-09-20,6398.85,6529.26,6395.95,6519.67,6519.67,4348110000,BTC,6624.047143,5885.56281606698,7362.531469933019,0.4293301569218904,35.1706234732222500000,6412.459333,0.01671911842750707,1,220864727264,6529.17,6519.67,-0.0014550088296,2018-09-20,0.031847134,0.025477707,0.9426752,0.3203631,157,-98.97046409164523,-98.02463276038314,-0.9458313312620845
549,2018-09-21,6513.87,6794.33,6496.36,6734.95,6734.95,6531940000,BTC,6609.636190,5893.574134184271,7325.698245815729,0.5875020600395058,58.9550521855355000000,6426.178000,0.04804908920979157,1,227396667264,6467.07,6734.95,0.0414221587210,2018-09-21,0.045801528,0.03816794,0.9160305,0.2897786,131,-70.88741296997341,-92.5971888023012,21.709775832327793
550,2018-09-22,6735.05,6814.56,6616.80,6721.98,6721.98,4509660000,BTC,6587.194762,5920.0869116903505,7254.30261230965,0.601022074569679,80.1190167412870000000,6443.172000,0.04327185429785205,-1,222887007264,6225.98,6721.98,0.0796661730362,2018-09-22,0.08045977,0.022988506,0.8965517,0.3002874,87,-49.111832598635374,-83.90011756156804,34.788284962932664
551,2018-09-23,6715.32,6766.15,6679.42,6710.63,6710.63,4197500000,BTC,6560.428571,5967.906703444524,7152.9504385554765,0.6267475828526589,96.1685928750172500000,6475.482000,0.03631359024702717,-1,218689507264,6300.86,6710.63,0.0650339794885,2018-09-23,0.03723404,0.4680851,0.49468085,-0.0672234,188,-32.39692680800181,-73.5994794108548,41.20255260285299
552,2018-09-24,6704.77,6713.56,6580.90,6595.41,6595.41,4177310000,BTC,6528.778571,6029.55633398383,7028.00080801617,0.5667352373947255,90.3348298792392500000,6495.118667,0.01544103166421794,-1,214512197264,6329.70,6595.41,0.0419782928101,2018-09-24,0.041666668,0.44444445,0.5138889,-0.0296204,216,-28.123346182201203,-64.50425276512408,36.380906582922876
553,2018-09-25,6603.64,6603.64,6381.86,6446.47,6446.47,4726180000,BTC,6485.198095,6162.920878764098,6807.475311235901,0.43991493495517353,74.4406150032062500000,6502.903333,-0.00867817497972332,-1,209786017264,6321.20,6446.47,0.0198174397266,2018-09-25,0.07317073,0.032520324,0.8943089,0.2301789,123,-36.33585884082095,-58.87057398026345,22.534715139442504
554,2018-09-26,6452.79,6585.91,6397.89,6495.00,6495.00,4437300000,BTC,6471.015714,6180.999241876679,6761.0321861233215,0.5413498685512615,61.8573002754820000000,6514.490000,-0.00299179214336042,1,214223317264,6351.80,6495.00,0.0225447904531,2018-09-26,0.07194245,0.043165468,0.8848921,0.2526763,139,-38.48474073756461,-54.793407331723685,16.308666594159078
555,2018-09-27,6495.29,6712.10,6464.95,6676.75,6676.75,4606810000,BTC,6478.043333,6175.238012747312,6780.848653252688,0.8281096032826993,59.9906336088152500000,6536.153333,0.02151061332820174,1,218830127264,6517.31,6676.75,0.0244640810396,2018-09-27,0.0661157,0.041322313,0.892562,0.2928926,121,-25.23118962262015,-48.88096378990298,23.64977416728283
556,2018-09-28,6678.75,6785.03,6598.32,6644.13,6644.13,5014430000,BTC,6486.474762,6175.210627245026,6797.738896754973,0.7532499257007336,62.6749311294765000000,6544.608000,0.01520671673536444,-1,213815697264,6512.71,6644.13,0.0201790038248,2018-09-28,0.08,0.056,0.864,0.196176,125,-17.161983596693972,-42.53716775126118,25.375184154567208
557,2018-09-29,6643.10,6643.10,6511.65,6601.96,6601.96,4363690000,BTC,6504.378571,6213.457738862752,6795.299403137248,0.6677113121860654,71.2418732782367500000,6550.558000,0.00784696509824049,-1,209452007264,6543.20,6601.96,0.0089803154420,2018-09-29,0.06140351,0.01754386,0.92105263,0.2793684,114,-14.008366526846658,-36.83140750637828,22.82304097953162
558,2018-09-30,6604.71,6643.78,6566.54,6625.56,6625.56,4002280000,BTC,6519.840476,6240.047944972012,6799.633007027988,0.68892485015875,78.4352617079890000000,6556.048667,0.01060262614429430,1,213454287264,6517.18,6625.56,0.0166298920699,2018-09-30,0.08988764,0.0,0.9101124,0.279427,89,-9.495323335065223,-31.364190672115665,21.868867337050443
559,2018-10-01,6619.85,6653.30,6549.08,6589.62,6589.62,4000970000,BTC,6532.217619,6265.040518042245,6799.394719957755,0.6074238413288946,73.6347107438017500000,6560.878000,0.00438081610418606,-1,209453317264,6281.20,6589.62,0.0491020824046,2018-10-01,0.048699763,0.0070921984,0.93427896,0.2282028,4230,-8.7182630185971,-26.83500514141195,18.116742122814852
560,2018-10-02,6593.24,6611.84,6537.90,6556.10,6556.10,3979260000,BTC,6543.403333,6294.271871852811,6792.534794147189,0.5254818619485776,66.3430910734787500000,6579.204667,-0.00351177204075874,-1,205474057264,6371.30,6556.10,0.0290050696090,2018-10-02,0.08943089,0.008130081,0.902439,0.2446423,123,-10.68406176759072,-23.604816466647705,12.920754699056985
561,2018-10-03,6553.86,6571.46,6454.03,6502.59,6502.59,3887310000,BTC,6550.583810,6316.402866498938,6784.764753501062,0.39752836144034426,56.4027439321387500000,6587.957333,-0.01295808832464398,-1,201586747264,6398.54,6502.59,0.0162615221597,2018-10-03,0.05970149,0.0074626864,0.92537314,0.1959552,134,-16.371065781559082,-22.158066329629982,5.7870005480709
562,2018-10-04,6497.91,6603.31,6497.91,6576.69,6576.69,3838410000,BTC,6553.411429,6319.484066659831,6787.338791340168,0.5497559814446781,48.7147522699412500000,6599.834000,-0.00350675486686483,1,205425157264,6519.67,6576.69,0.0087458414306,2018-10-04,0.08163265,0.010204081,0.90816325,0.2630102,98,-14.729019743710523,-20.672257012446092,5.943237268735569
563,2018-10-05,6574.15,6623.62,6557.41,6622.48,6622.48,3671500000,BTC,6558.638571,6323.627876750933,6793.649265249068,0.6358266465362192,46.9751385980537500000,6606.688000,0.00239030509689575,1,209096657264,6734.95,6622.48,-0.0166994558237,2018-10-05,0.07526882,0.021505376,0.9032258,0.3234624,93,-9.621900828089565,-18.46218577557479,8.840284947485223
564,2018-10-06,6622.45,6628.54,6577.80,6588.31,6588.31,3259740000,BTC,6560.786667,6325.544121670008,6796.029212329992,0.5584999047714585,47.1412912181890000000,6596.912000,-0.00130394342080052,-1,205836917264,6721.98,6588.31,-0.0198855099242,2018-10-06,0.06329114,0.012658228,0.9240506,0.2290633,79,-8.23675750869188,-16.417100122198207,8.180342613506326
565,2018-10-07,6590.68,6641.49,6557.04,6602.95,6602.95,3306630000,BTC,6564.870952,6329.830031400649,6799.911872599351,0.5810051456208105,54.2181176282917500000,6588.976667,0.00212071368684360,1,209143547264,6710.63,6602.95,-0.0160461834433,2018-10-07,0.10810811,0.0,0.8918919,0.2915405,74,-5.889801831002842,-14.311640463959133,8.421838632956291
566,2018-10-08,6600.19,6675.06,6576.04,6652.23,6652.23,3979460000,BTC,6582.539048,6384.131299975406,6780.946796024593,0.6756255808905243,65.2711298116800000000,6585.083333,0.01019678318473301,1,213123007264,6595.41,6652.23,0.0086150823072,2018-10-08,0.05940594,0.0,0.9405941,0.3149505,101,-0.05273055268662574,-11.45985848170463,11.407127929018005
567,2018-10-09,6653.08,6661.41,6606.94,6642.64,6642.64,3580810000,BTC,6595.460000,6420.924966038334,6769.995033961666,0.6351591108360589,71.3148054447875000000,6588.232000,0.00825836127203778,-1,209542197264,6446.47,6642.64,0.0304306077590,2018-10-09,0.10227273,0.03409091,0.8636364,0.2770682,88,3.7560601132599913,-8.416674762711706,12.172734875971697
568,2018-10-10,6640.29,6640.29,6538.96,6585.53,6585.53,3787650000,BTC,6604.364286,6454.719041161225,6754.009530838775,0.43707021556116965,70.8966739485505000000,6597.502667,-0.00181472711786628,-1,205754547264,6495.00,6585.53,0.0139384141647,2018-10-10,0.082474224,0.020618556,0.8969072,0.2082268,97,2.141567784719882,-6.305026253225388,8.446594037945271
569,2018-10-11,6586.74,6586.74,6243.74,6256.24,6256.24,5181640000,BTC,6591.820000,6380.783817509888,6802.856182490112,-0.2950769295585685,56.0874674070605000000,6581.585333,-0.04943266956803278,-1,200572907264,6676.75,6256.24,-0.0629812408732,2018-10-11,0.05882353,0.0,0.9411765,0.3083725,102,-25.415901336327806,-10.127201269845873,-15.288700066481933
570,2018-10-12,6239.25,6328.50,6236.47,6274.58,6274.58,3783500000,BTC,6569.897619,6327.929040138631,6811.86619786137,-0.11023960298827849,34.9073016527032500000,6554.774000,-0.04274655388576326,1,204356407264,6644.13,6274.58,-0.0556205251854,2018-10-12,0.029411765,0.009803922,0.9607843,0.2647059,102,-45.2538512022611,-17.152531256328924,-28.10131994593218
571,2018-10-13,6278.08,6308.51,6259.81,6285.99,6285.99,3064030000,BTC,6549.136190,6287.921077077628,6810.351302922372,-0.003696334901959071,15.4886062209690000000,6530.898000,-0.03749989664514742,1,207420437264,6601.96,6285.99,-0.0478600294458,2018-10-13,0.104477614,0.0,0.880597,0.2087463,67,-59.37049168181329,-25.596123341425802,-33.77436834038749
572,2018-10-14,6288.49,6363.21,6280.15,6290.93,6290.93,3085320000,BTC,6529.150476,6255.885455152017,6802.4154968479825,0.06412190030622039,5.2261420742947500000,6510.162667,-0.03367545147700992,1,210505757264,6625.56,6290.93,-0.0505059194996,2018-10-14,0.083333336,0.0,0.9166667,0.2702639,72,-69.35987676770856,-34.34887402668236,-35.011002741026196
573,2018-10-15,6292.64,6965.06,6258.68,6596.54,6596.54,7370770000,BTC,6529.204286,6255.88402670176,6802.52454529824,0.6231809785576943,26.7102704613752500000,6508.228000,0.01356928491134607,1,217876527264,6589.62,6596.54,0.0010501364267,2018-10-15,0.053097345,0.0088495575,0.920354,0.2168761,113,-52.016746829105614,-37.88244858716701,-14.134298241938602
574,2018-10-16,6601.41,6673.59,6571.37,6596.11,6596.11,4074800000,BTC,6536.330000,6264.269366537531,6808.390633462469,0.6098652150426725,47.0093941766207500000,6508.660667,0.01343584148477470,-1,213801727264,6556.10,6596.11,0.0061027135035,2018-10-16,0.058333334,0.008333334,0.925,0.2643,120,-37.87034306719033,-37.88002748317168,0.009684415981347172
575,2018-10-17,6590.52,6601.21,6517.45,6544.43,6544.43,4088420000,BTC,6538.683810,6267.270459666884,6810.097160333117,0.510585680462931,63.3254627642112500000,6507.882667,0.00561585616552727,-1,209713307264,6502.59,6544.43,0.0064343592322,2018-10-17,0.026548672,0.0,0.9734513,0.2991681,113,-30.478028517914936,-36.39962769012033,5.921599172205397
576,2018-10-18,6542.33,6567.54,6450.04,6476.71,6476.71,3924080000,BTC,6529.158095,6264.130175744759,6794.1860142552405,0.40105175494833717,75.0542943003612500000,6506.157333,-0.00452607145705494,-1,205789227264,6576.69,6476.71,-0.0152021761707,2018-10-18,0.072916664,0.010416667,0.9166667,0.2315938,96,-29.741166366569814,-35.067935425410234,5.326769058840419
577,2018-10-19,6478.07,6493.68,6445.31,6465.41,6465.41,3578870000,BTC,6520.647619,6259.678931843495,6781.616306156506,0.3941681095884237,66.7756761534382500000,6498.738667,-0.00512848241909463,-1,202210357264,6622.48,6465.41,-0.0237177009217,2018-10-19,0.054545455,0.018181818,0.92727274,0.3576545,110,-29.726346545810884,-33.99961764949036,4.273271103679477
578,2018-10-20,6460.92,6497.72,6449.00,6489.19,6489.19,3379130000,BTC,6515.277619,6256.70632052279,6773.848917477211,0.4495543025199681,60.0255056945882500000,6489.852667,-0.00010210817317465,1,205589487264,6588.31,6489.19,-0.0150448294024,2018-10-20,0.06410257,0.012820513,0.9230769,0.2902179,78,-27.478993734153846,-32.69549286642306,5.216499132269213
579,2018-10-21,6490.09,6556.38,6476.00,6482.35,6482.35,3253610000,BTC,6508.458095,6254.591601533922,6762.324588466078,0.4485790845346667,56.1062148034040000000,6482.788667,-0.00006766640446464,-1,202335877264,6602.95,6482.35,-0.0182645635663,2018-10-21,0.106796116,0.0,0.89320385,0.3320097,103,-25.950737329190815,-31.34654175897661,5.3958044297857946
580,2018-10-22,6486.05,6543.80,6462.98,6487.16,6487.16,3672860000,BTC,6503.579048,6252.339150937072,6754.818945062927,0.46732396368581675,56.7659536856990000000,6475.069333,0.00186726448447127,1,206008737264,6652.23,6487.16,-0.0248142352264,2018-10-22,0.06603774,0.009433962,0.9245283,0.3426132,106,-24.073946842918303,-29.89202277576495,5.8180759328466465
581,2018-10-23,6472.36,6506.01,6451.27,6475.74,6475.74,3716150000,BTC,6499.752381,6249.426001814364,6750.078760185636,0.4520378533854128,57.7620480004070000000,6463.303333,0.00192419670859350,1,209724887264,6642.64,6475.74,-0.0251255524912,2018-10-23,0.06542056,0.0,0.93457943,0.3311028,107,-23.240177124695037,-28.561653645550972,5.321476520855935
582,2018-10-24,6478.89,6521.99,6468.86,6495.84,6495.84,3424670000,BTC,6499.430952,6249.102541474565,6749.759362525434,0.49282751807423253,60.6573530025510000000,6453.516667,0.00655818140463168,1,213149557264,6585.53,6495.84,-0.0136192531201,2018-10-24,0.1,0.011111111,0.8888889,0.3279222,90,-20.718674614691736,-26.993057839379127,6.274383224687391
583,2018-10-25,6484.65,6504.65,6447.03,6476.29,6476.29,3230550000,BTC,6494.650000,6246.69512458917,6742.60487541083,0.46297713450969763,62.5482543554667500000,6446.234000,0.00466256732225358,-1,209919007264,6256.24,6476.29,0.0351728833932,2018-10-25,0.067961164,0.0,0.93203884,0.2758155,103,-20.0665723676575,-25.607760745034806,5.541188377377306
584,2018-10-26,6468.44,6498.29,6449.61,6474.75,6474.75,3306050000,BTC,6487.615238,6246.607206215244,6728.623269784756,0.4733095243657891,63.5126832651320000000,6460.801333,0.00215896856768433,1,213225057264,6274.58,6474.75,0.0319017368493,2018-10-26,0.078947365,0.0,0.90789473,0.2802632,76,-19.449836164225417,-24.37617582887293,4.926339664647514
585,2018-10-27,6480.84,6507.41,6453.53,6480.38,6480.38,3393250000,BTC,6482.475714,6245.924424967669,6719.027003032331,0.49557027567135004,64.9599275268822500000,6474.521333,0.00090488032993867,-1,209831807264,6285.99,6480.38,0.0309243253648,2018-10-27,0.14814815,0.0,0.8518519,0.3075432,81,-18.295870920347625,-23.160114847167872,4.864243926820247
586,2018-10-28,6482.66,6502.28,6447.91,6486.39,6486.39,3445190000,BTC,6476.925238,6246.865738598733,6706.984737401267,0.5205702481849971,63.3471445564785000000,6487.881333,-0.00022986440772498,1,213276997264,6290.93,6486.39,0.0310701279461,2018-10-28,0.06410257,0.012820513,0.9230769,0.3056538,78,-16.703836943857823,-21.868859266505865,5.165022322648042
587,2018-10-29,6492.35,6503.60,6306.99,6332.63,6332.63,4199910000,BTC,6461.706190,6238.1610201147,6685.2513598853,0.21129729605379532,47.1812615121060000000,6490.661333,-0.02434749325103942,-1,209077087264,6596.54,6332.63,-0.0400073371798,2018-10-29,0.08988764,0.033707865,0.8651685,0.2537528,89,-27.53191474639334,-23.001470362483364,-4.530444383909977
588,2018-10-30,6337.04,6364.99,6310.14,6334.27,6334.27,3781100000,BTC,6447.021905,6233.088756131569,6660.95505386843,0.23647864859563658,31.7937911603365000000,6473.176667,-0.02145880981561043,-1,205295987264,6596.11,6334.27,-0.0396961239276,2018-10-30,0.0754717,0.0,0.9245283,0.3240472,106,-35.570871261242246,-25.515350542235144,-10.055520719007102
589,2018-10-31,6336.99,6349.16,6316.88,6317.61,6317.61,4191240000,BTC,6434.263810,6223.085325918293,6645.442294081708,0.22380280475243372,16.1449423437207500000,6454.610000,-0.02122513986127744,-1,201104747264,6544.43,6317.61,-0.0346584805705,2018-10-31,0.07692308,0.006993007,0.91608393,0.3062308,143,-42.792835809784265,-28.970847595744974,-13.82198821403929
590,2018-11-01,6318.14,6547.14,6311.83,6377.78,6377.78,3789400000,BTC,6440.051429,6243.187883640711,6636.914974359289,0.34184113700088314,8.5955466937802500000,6443.500000,-0.01019942577791573,1,204894147264,6476.71,6377.78,-0.0152747305345,2018-11-01,0.05882353,0.025210084,0.9159664,0.2480756,119,-43.163516458244885,-31.80938136824496,-11.354135089999925
591,2018-11-02,6378.92,6396.86,6327.38,6388.44,6388.44,4234870000,BTC,6445.473333,6261.929395335654,6629.017270664346,0.3446330243162285,18.5307427887137500000,6437.615333,-0.00763874982525303,1,209129017264,6465.41,6388.44,-0.0119048907958,2018-11-02,0.1,0.0125,0.8875,0.220525,80,-42.11167347389619,-33.869839789375206,-8.241833684520984
592,2018-11-03,6387.24,6400.07,6342.37,6361.26,6361.26,3658640000,BTC,6449.057619,6275.951265574741,6622.163972425259,0.24640555570969327,24.4978398698312500000,6430.672000,-0.01079389525698092,-1,205470377264,6489.19,6361.26,-0.0197143249003,2018-11-03,0.09756097,0.0121951215,0.8902439,0.2636707,82,-42.9758799850315,-35.69104782850646,-7.2848321565250345
593,2018-11-04,6365.47,6388.63,6294.57,6376.13,6376.13,4390020000,BTC,6453.114762,6291.995257827595,6614.234266172405,0.26109421886743467,32.7063345115862500000,6423.134667,-0.00731802607868318,1,209860397264,6482.35,6376.13,-0.0163860328430,2018-11-04,0.09195402,0.0,0.90804595,0.2887471,87,-41.977000414155555,-36.948238345636284,-5.028762068519271
594,2018-11-05,6363.62,6480.59,6363.62,6419.66,6419.66,4174800000,BTC,6444.691905,6297.141194853412,6592.242615146587,0.4151752472925025,38.5807664254052500000,6418.955333,0.00010977907828355,1,214035197264,6487.16,6419.66,-0.0104051695966,2018-11-05,0.0625,0.0,0.9375,0.3244107,112,-37.243553452196466,-37.00730136694832,-0.23625208524814667
595,2018-11-06,6433.38,6463.55,6408.16,6461.01,6461.01,4700040000,BTC,6438.258571,6307.624917099374,6568.892224900626,0.5870810404541967,48.7600291757840000000,6417.212000,0.00682508229430475,1,218735237264,6475.74,6461.01,-0.0022746435156,2018-11-06,0.053097345,0.0088495575,0.9292035,0.3055575,113,-29.81200892698962,-35.56824287895658,5.756233951966962
596,2018-11-07,6468.50,6552.16,6468.31,6530.14,6530.14,4941260000,BTC,6437.578095,6309.1367789651595,6566.01941103484,0.8603276105287359,67.6373225607360000000,6420.838667,0.01702290598917489,1,223676497264,6495.84,6530.14,0.0052803024705,2018-11-07,0.074074075,0.009259259,0.9166667,0.3065463,108,-18.135191889554335,-32.08163268107613,13.946440791521795
597,2018-11-08,6522.27,6536.92,6438.53,6453.72,6453.72,4665260000,BTC,6436.483333,6309.054964991407,6563.911701008593,0.5676327699607587,75.4395087640382500000,6418.030667,0.00556079190825718,-1,219011237264,6476.29,6453.72,-0.0034850199729,2018-11-08,0.06,0.02,0.92,0.20185,100,-14.87620199538651,-28.640546543938203,13.764344548551694
598,2018-11-09,6442.60,6456.46,6373.37,6385.62,6385.62,4346820000,BTC,6432.683810,6304.124790483486,6561.242829516515,0.3169564057932359,69.1251867425502500000,6411.986000,-0.00411198652024505,-1,214664417264,6474.75,6385.62,-0.0137657824626,2018-11-09,0.06896552,0.011494253,0.9195402,0.1801724,87,-17.585811599721637,-26.429599555094892,8.843787955373255
599,2018-11-10,6386.13,6437.28,6385.31,6409.22,6409.22,3705320000,BTC,6428.875714,6302.629783440409,6555.121644559591,0.42215307886410824,59.7868536206652500000,6407.617333,0.00025011902501513,1,218369737264,6480.38,6409.22,-0.0109808375435,2018-11-10,0.13846155,0.0,0.86153847,0.2389538,65,-17.62569591537249,-24.668818827150414,7.043122911777925
600,2018-11-11,6413.63,6423.25,6350.17,6411.27,6411.27,3939060000,BTC,6425.490952,6301.474785327302,6549.507118672698,0.44266492675293123,45.8041217710440000000,6403.010000,0.00129001828827380,-1,214430677264,6486.39,6411.27,-0.0115811722699,2018-11-11,0.09756097,0.0,0.902439,0.2272805,82,-17.292548915779662,-23.193564844876267,5.901015929096605
601,2018-11-12,6411.76,6434.21,6360.47,6371.27,6371.27,4295770000,BTC,6419.972381,6297.173894868491,6542.770867131509,0.3016979584428991,36.1054909895072500000,6395.335333,-0.00376295092390584,-1,210134907264,6332.63,6371.27,0.0061017302448,2018-11-12,0.08974359,0.0,0.9102564,0.2768718,78,-20.025353415632708,-22.55992255902756,2.534569143394851
602,2018-11-13,6373.19,6395.27,6342.67,6359.49,6359.49,4503800000,BTC,6414.436667,6291.715922814946,6537.157411185054,0.276131299704537,33.0318072742672500000,6397.126000,-0.00588326695456679,-1,205631107264,6334.27,6359.49,0.0039815164178,2018-11-13,0.039215688,0.009803922,0.95098037,0.212451,102,-22.877945506224023,-22.623527148466852,-0.2544183577571708
603,2018-11-14,6351.24,6371.55,5544.09,5738.35,5738.35,7398940000,BTC,6378.365714,6062.63000245812,6694.1014255418795,-0.5135307641864674,22.2556815508400000000,6357.398000,-0.09737442897235630,-1,198232167264,6317.61,5738.35,-0.0916897370999,2018-11-14,0.06569343,0.0,0.93430656,0.2588248,137,-74.40179463125969,-32.97918064502543,-41.42261398623426
604,2018-11-15,5736.15,5774.82,5358.38,5648.03,5648.03,7032140000,BTC,6338.924762,5894.047492559583,6783.802031440417,-0.27650040748208243,11.2384134004612500000,6312.759333,-0.10529933075780698,-1,191200027264,6377.78,5648.03,-0.1144206918395,2018-11-15,0.048,0.008,0.944,0.16516,125,-121.12661323769862,-50.60866716356008,-70.51794607413854
605,2018-11-16,5645.32,5657.02,5498.94,5575.55,5575.55,5279320000,BTC,6296.105714,5745.584403147407,6846.627024852593,-0.15443035518831633,4.9263633369407500000,6259.277333,-0.10923422890934556,-1,185920707264,6388.44,5575.55,-0.1272438967886,2018-11-16,0.093023255,0.023255814,0.88372093,0.2477791,86,-162.13589718020467,-72.91411316688901,-89.22178401331566
606,2018-11-17,5578.58,5578.58,5519.56,5554.33,5554.33,4303150000,BTC,6252.008095,5621.007910162656,6883.008279837344,-0.052835095587051274,0E-19,6203.670000,-0.10467029999983881,-1,181617557264,6361.26,5554.33,-0.1268506553733,2018-11-17,0.0945946,0.013513514,0.8918919,0.1997973,74,-194.11073904763543,-97.1534383430383,-96.95730070459713
607,2018-11-18,5559.74,5653.61,5559.74,5623.54,5623.54,4159680000,BTC,6210.920000,5533.366965500117,6888.473034499883,0.06654315596596944,1.7731423125402500000,6154.488667,-0.08627015106013843,1,185777237264,6376.13,5623.54,-0.1180324115098,2018-11-18,0.071428575,0.0,0.9285714,0.2072738,84,-211.42913949593458,-120.00857857361757,-91.42056092231701
608,2018-11-19,5620.78,5620.78,4842.91,4871.49,4871.49,7039560000,BTC,6141.341905,5249.940016341039,7032.743793658961,-0.21227799781217957,1.7731423125402500000,6054.179333,-0.19535089199512485,-1,178737677264,6419.66,4871.49,-0.2411607468308,2018-11-19,0.02919708,0.00729927,0.96350366,0.2195474,137,-282.5808305651617,-152.5230289719264,-130.0578015932353
609,2018-11-20,4863.93,4951.61,4272.11,4451.87,4451.87,8428290000,BTC,6051.703810,4900.934853858478,7202.472766141522,-0.19511512344066578,1.7731423125402500000,5922.993333,-0.24837497702447608,-1,170309387264,6461.01,4451.87,-0.3109637657270,2018-11-20,0.07092199,0.0,0.9148936,0.2081773,141,-368.5801232197955,-195.73444782150025,-172.84567539829524
610,2018-11-21,4465.54,4675.73,4343.98,4602.17,4602.17,6120120000,BTC,5970.016190,4665.281894773938,7274.750485226063,-0.024185726934924653,3.5811364615200000000,5799.070667,-0.20639525464158307,1,176429507264,6530.14,4602.17,-0.2952417559195,2018-11-21,0.032258064,0.008064516,0.9596774,0.1474274,124,-419.7683995364496,-240.54123816449018,-179.2271613719594
611,2018-11-22,4611.57,4629.64,4365.64,4365.94,4365.94,4569370000,BTC,5874.214286,4409.584032173849,7338.844539826152,-0.014899334511162435,1.8079941489797500000,5654.790667,-0.22792190602588048,-1,171860137264,6453.72,4365.94,-0.3235002448200,2018-11-22,0.07070707,0.030303031,0.8989899,0.2150303,99,-473.93404736816956,-287.2198000052261,-186.71424736294347
612,2018-11-23,4360.70,4396.42,4195.68,4347.11,4347.11,4871490000,BTC,5777.008095,4189.878711268238,7364.137478731763,0.049533229723864605,1.8079941489797500000,5514.350000,-0.21167317997588111,-1,166988647264,6385.62,4347.11,-0.3192344674440,2018-11-23,0.061946902,0.0,0.920354,0.2178761,113,-512.4726711979438,-332.27037424376965,-180.20229695417413
613,2018-11-24,4347.69,4413.09,3795.16,3880.76,3880.76,4679500000,BTC,5658.889048,3895.0120309502868,7422.766065049713,-0.004039972972187345,1.8079941489797500000,5347.359333,-0.27426608942272105,-1,162309147264,6409.22,3880.76,-0.3945035433329,2018-11-24,0.062015504,0.0,0.93798447,0.2840155,129,-574.0283146976462,-380.621962334545,-193.40635236310123
614,2018-11-25,3880.78,4120.87,3585.06,4009.97,4009.97,6825640000,BTC,5546.214762,3675.6958655264134,7416.733658473586,0.08935331663951109,1.2765213336442500000,5187.409333,-0.22698022411874317,1,169134787264,6411.27,4009.97,-0.3745435771696,2018-11-25,0.050847456,0.008474576,0.94067794,0.1614831,118,-605.4066870726547,-425.57890728216694,-179.82777979048774
615,2018-11-26,4015.07,4107.14,3643.92,3779.13,3779.13,6476900000,BTC,5420.475238,3444.526468556631,7396.424007443369,0.0846690806507165,1.2765213336442500000,5011.933333,-0.24597360960148270,-1,162657887264,6371.27,3779.13,-0.4068482421872,2018-11-26,0.053846154,0.0076923077,0.93846154,0.2373923,130,-641.5062473428443,-468.7643752943025,-172.74187204854178
616,2018-11-27,3765.95,3862.96,3661.01,3820.72,3820.72,5998720000,BTC,5294.747143,3261.6995146435675,7327.794771356432,0.13748337165331412,1.6794689843597500000,4841.896667,-0.21090426690842884,1,168656607264,6359.49,3820.72,-0.3992096850534,2018-11-27,0.07462686,0.0074626864,0.9104478,0.2332537,134,-659.1610453056101,-506.84370929656404,-152.31733600904602
617,2018-11-28,3822.47,4385.90,3822.47,4257.42,4257.42,7280280000,BTC,5186.522381,3188.007892447018,7185.036869552981,0.2675517524837377,7.7825355108345000000,4701.758667,-0.09450477969417225,1,175936887264,5738.35,4257.42,-0.2580759277493,2018-11-28,0.056173004,0.008837707,0.92742366,0.2330467,14936,-630.6448779510183,-531.603943027455,-99.04093492356333
618,2018-11-29,4269.00,4413.02,4145.77,4278.85,4278.85,6503347767,BTC,5082.957143,3135.490110117103,7030.424175882896,0.2935505121723026,13.1906950054850000000,4604.458667,-0.07071594959329885,1,182440235031,5648.03,4278.85,-0.2424172676137,2018-11-29,0.05229176,0.0090136165,0.929681,0.2270726,15643,-599.4067995056712,-545.1645143230983,-54.242285182572914
619,2018-11-30,4289.09,4322.98,3942.82,4017.27,4017.27,6048016717,BTC,4970.178571,3065.720713327265,6874.636428672736,0.24982156544948092,16.4185564896452500000,4495.741333,-0.10642768290245848,-1,176392218314,5575.55,4017.27,-0.2794845351580,2018-11-30,0.04347826,0.026086956,0.93043476,0.1932087,115,-588.9684554301921,-553.9253025445171,-35.043152885675
620,2018-12-01,4024.46,4309.38,3969.71,4214.67,4214.67,5375314093,BTC,4865.676190,3054.300142543523,6677.052237456477,0.32030065184031253,21.9191226997307500000,4405.016000,-0.04321119378454017,1,181767532407,5554.33,4214.67,-0.2411920069567,2018-12-01,0.05263158,0.00877193,0.9385965,0.3224561,114,-558.3313658504849,-554.8065152057106,-3.524850644774233
621,2018-12-02,4200.73,4301.52,4110.98,4139.88,4139.88,5262697895,BTC,4757.514762,3066.4997398713494,6448.52978412865,0.3173775058418698,20.7058312232720000000,4310.719333,-0.03963128188192808,-1,176504834512,5623.54,4139.88,-0.2638302563865,2018-12-02,0.072164945,0.0,0.92783505,0.3099794,97,-533.9313513267762,-550.6314824299237,16.700131103147555
622,2018-12-03,4147.32,4155.98,3840.45,3894.13,3894.13,5089570994,BTC,4639.555714,3080.922644370442,6198.188783629558,0.2608719689948687,16.6530666130737500000,4195.425333,-0.07181520563126180,-1,171415263518,4871.49,3894.13,-0.2006285551238,2018-12-03,0.07692308,0.0076923077,0.9153846,0.2673,130,-528.333831670574,-546.1719522780538,17.838120607479823
623,2018-12-04,3886.29,4075.63,3832.75,3956.89,3956.89,5028069239,BTC,4525.146190,3155.499269286838,5894.793110713163,0.292553766446569,18.8246996856787500000,4134.452000,-0.04294692500965061,1,176443332757,4451.87,3956.89,-0.1111847380988,2018-12-04,0.03649635,0.02189781,0.94160587,0.3263285,137,-512.9209164792974,-539.5217451183025,26.600828639005158
624,2018-12-05,3958.89,3969.54,3753.99,3753.99,3753.99,5302481574,BTC,4430.652857,3141.0813752411505,5720.22433875885,0.23764042297325846,12.9211858248777500000,4087.926667,-0.08168851699217627,-1,171140851183,4602.17,3753.99,-0.1843000149929,2018-12-05,0.04347826,0.017391304,0.9391304,0.231,115,-511.18577305047074,-533.8545507047362,22.668777654265455
625,2018-12-06,3754.07,3874.97,3521.10,3521.10,3521.10,5878333109,BTC,4329.370476,3109.1383841178667,5549.602567882133,0.16880461455767304,8.0314107748617500000,4015.855333,-0.12320048706296363,-1,165262518074,4365.94,3521.10,-0.1935070110904,2018-12-06,0.049586777,0.03305785,0.91735536,0.1896694,121,-522.5789709560854,-531.5994347550061,9.020463798920673
626,2018-12-07,3512.59,3512.59,3280.23,3419.94,3419.94,6835615448,BTC,4226.722381,3086.751950227258,5366.692811772741,0.14613890008835,5.3994945567652500000,3952.788667,-0.13480322675697451,-1,158426902626,4347.11,3419.94,-0.2132842279123,2018-12-07,0.09090909,0.007575758,0.8939394,0.2594242,132,-533.6196932928942,-532.0034864625837,-1.6162068303104888
627,2018-12-08,3421.91,3506.04,3350.65,3476.11,3476.11,5305024497,BTC,4127.759524,3118.514927036982,5137.004120963018,0.17715976584817997,1.6349210045290000000,3894.722000,-0.10748186905252801,1,163731927123,3880.76,3476.11,-0.1042708129335,2018-12-08,0.093333334,0.04,0.8666667,0.1937467,75,-531.7078980491642,-531.9443687798998,0.23647073073561842
628,2018-12-09,3473.23,3685.31,3469.09,3614.23,3614.23,4947372847,BTC,4032.078095,3266.9672572615964,4797.188932738403,0.2269362330331642,7.2900536726782500000,3876.953333,-0.06776541021624931,1,168679299970,4009.97,3614.23,-0.0986890176236,2018-12-09,0.09090909,0.0,0.90909094,0.2347273,66,-513.1325838491002,-528.1820117937399,15.04942794463966
629,2018-12-10,3612.05,3647.33,3470.14,3502.66,3502.66,5020968740,BTC,3966.895714,3272.141002563757,4661.6504254362435,0.16589955680883303,9.6977564587675000000,3843.132667,-0.08859248339864818,-1,163658331230,3779.13,3502.66,-0.0731570493738,2018-12-10,0.07446808,0.0,0.9255319,0.1476809,94,-501.6317811698582,-522.8719656689635,21.24018449910534
630,2018-12-11,3497.55,3513.19,3392.25,3424.59,3424.59,4696765188,BTC,3917.977619,3221.980004868896,4613.975233131104,0.14555365637570924,9.8331024205097500000,3819.496667,-0.10339233187763900,-1,158961566042,3820.72,3424.59,-0.1036794112105,2018-12-11,0.06603774,0.018867925,0.8962264,0.2514906,106,-493.1323855531318,-516.9240496457971,23.791664092665314
631,2018-12-12,3421.46,3534.23,3413.48,3486.95,3486.95,4139364829,BTC,3864.871905,3219.8130807174693,4509.930729282531,0.20706399883735768,10.1486185979905000000,3797.245333,-0.08171590344805356,1,163100930871,4257.42,3486.95,-0.1809711045657,2018-12-12,0.076271184,0.0,0.9237288,0.2572712,118,-475.87898573315306,-508.7150368632683,32.836051130115266
632,2018-12-13,3487.88,3489.74,3298.13,3313.68,3313.68,4343372456,BTC,3814.764286,3169.702820631887,4459.825751368113,0.11159958166618313,4.4934859298412500000,3734.329333,-0.11264387671509100,-1,158757558415,4278.85,3313.68,-0.2255676174673,2018-12-13,0.04511278,0.0,0.94736844,0.264203,133,-470.7603507091453,-501.12409963244374,30.36374892329843
633,2018-12-14,3311.75,3329.56,3206.54,3242.48,3242.48,4372763663,BTC,3762.162857,3119.2734888146842,4405.052225185315,0.09582248306041435,2.0857831437520000000,3665.238000,-0.11534257802631098,-1,154384794752,4017.27,3242.48,-0.1928648061992,2018-12-14,0.053030305,0.007575758,0.93939394,0.2130833,132,-467.06500588168547,-494.31228088229216,27.24727500060669
634,2018-12-15,3244.00,3275.38,3191.30,3236.76,3236.76,3551763561,BTC,3731.496190,3051.9717614037595,4411.020618596241,0.13596879730871167,1.9504371820097500000,3613.204000,-0.10418564797337764,-1,150833031191,4214.67,3236.76,-0.2320252831183,2018-12-15,0.06422018,0.0091743115,0.9266055,0.2666514,109,-459.30341086436783,-487.3105068787074,28.007096014339538
635,2018-12-16,3236.27,3305.75,3233.82,3252.84,3252.84,3744248994,BTC,3695.442381,2997.870318689452,4393.014443310548,0.1827550837300017,0.4451235716185000000,3549.082000,-0.08347003534998628,1,154577280185,4139.88,3252.84,-0.2142670802052,2018-12-16,0.11392405,0.025316456,0.8607595,0.2813291,79,-446.7054271799807,-479.1894909389621,32.48406375898139
636,2018-12-17,3253.12,3597.92,3253.12,3545.86,3545.86,5409247918,BTC,3684.334286,2984.9325421768544,4383.736029823145,0.4010051896331738,11.1758249727545000000,3509.480667,0.01036601607242876,1,159986528103,3894.13,3545.86,-0.0894346105549,2018-12-17,0.05,0.007142857,0.94285715,0.2337286,140,-408.36973708902315,-465.02554016897426,56.65580307995111
637,2018-12-18,3544.76,3701.35,3487.17,3696.06,3696.06,5911325473,BTC,3678.398095,2981.747476666275,4375.048713333725,0.5126763003829987,27.1208626742805000000,3496.276000,0.05714194188330670,1,165897853576,3956.89,3696.06,-0.0659179304959,2018-12-18,0.06870229,0.0,0.9312977,0.3022519,131,-361.6990997005055,-444.3602520752805,82.66115237477504
638,2018-12-19,3706.82,3949.32,3687.23,3745.95,3745.95,6810689119,BTC,3654.042381,3008.5270680010053,4299.557693998995,0.5711893406316008,51.7322541248925000000,3482.213333,0.07573822789679153,1,172708542695,3753.99,3745.95,-0.0021417212086,2018-12-19,0.06542056,0.0,0.93457943,0.1985888,107,-317.03202938527966,-418.8946075372803,101.86257815200065
639,2018-12-20,3742.20,4191.23,3728.97,4134.44,4134.44,8927129279,BTC,3647.165714,3027.02793113005,4267.30349686995,0.892875824905339,76.2871305532740000000,3507.576667,0.17871692981016172,1,181635671974,3521.10,4134.44,0.1741898838431,2018-12-20,0.09821428,0.017857144,0.8839286,0.3403393,112,-247.43290558405988,-384.6022671466363,137.1693615625764
640,2018-12-21,4133.70,4198.43,3850.95,3896.54,3896.54,7206015706,BTC,3641.416667,3033.5728353677846,4249.260498632216,0.709859276119434,83.9310169785350000000,3532.606000,0.10302139553632644,-1,174429656268,3419.94,3896.54,0.1393591700439,2018-12-21,0.0625,0.0,0.9270833,0.2517396,96,-209.06170710066408,-349.49415513744185,140.43244803677777
641,2018-12-22,3898.08,4014.18,3855.74,4014.18,4014.18,5605823233,BTC,3631.869524,3056.406296661322,4207.3327513386785,0.832176286717794,89.6367902564225000000,3572.222000,0.12372075419724754,1,180035479501,3476.11,4014.18,0.1547908437880,2018-12-22,0.060240965,0.0,0.939759,0.2886747,83,-167.23194524500514,-313.0417131589545,145.80976791394937
642,2018-12-23,4020.99,4085.72,3976.41,3998.98,3998.98,6151275490,BTC,3625.160000,3071.7090598074656,4178.610940192534,0.8377173773252203,86.2528963550485000000,3607.080000,0.10864743781673819,-1,173884204011,3614.23,3998.98,0.1064542101637,2018-12-23,0.08,0.0,0.92,0.2606933,75,-133.76609826128333,-277.1865901794203,143.42049191813697
643,2018-12-24,4000.33,4271.79,4000.33,4078.60,4078.60,7240968501,BTC,3633.944286,3057.197850984701,4210.6907210152995,0.8854863133988894,84.6977764905087500000,3638.038000,0.12109879006211590,1,181125172512,3502.66,4078.60,0.1644293194315,2018-12-24,0.12048193,0.024096385,0.8433735,0.2247108,83,-99.6705646043929,-241.6833850644148,142.0128204600219
644,2018-12-25,4081.03,4089.56,3760.02,3815.49,3815.49,6158207293,BTC,3627.210952,3063.1373627971457,4191.284541202854,0.666892273990416,82.4405690223685000000,3658.893333,0.04279891561408358,-1,174966965219,3424.59,3815.49,0.1141450509404,2018-12-25,0.08888889,0.0,0.9111111,0.2543,90,-92.81052467828886,-211.90881298718963,119.09828830890078
645,2018-12-26,3819.67,3893.36,3769.86,3857.30,3857.30,5326547918,BTC,3632.130476,3061.647368959092,4202.6135830409075,0.6973498612149562,78.0715288298725000000,3687.740667,0.04597919113925589,1,180293513137,3486.95,3857.30,0.1062102983983,2018-12-26,0.114285715,0.014285714,0.87142855,0.2763,70,-83.04290907033601,-186.13563220381894,103.09272313348293
646,2018-12-27,3854.69,3874.42,3645.45,3654.83,3654.83,5130222366,BTC,3638.498571,3070.2396910065345,4206.757450993466,0.5143697085738349,68.4871000802067500000,3698.932667,-0.01192307916104059,-1,175163290771,3313.68,3654.83,0.1029520050216,2018-12-27,0.08974359,0.012820513,0.8974359,0.1605513,78,-90.59531383253398,-167.02756852956196,76.43225469702799
647,2018-12-28,3653.13,3956.14,3642.63,3923.92,3923.92,5631554348,BTC,3662.497619,3090.4498454389186,4234.545392561082,0.7284969831912875,64.1793289368150000000,3739.615333,0.04928439173238356,1,180794845119,3242.48,3923.92,0.2101601243493,2018-12-28,0.09677419,0.0,0.9032258,0.2315699,93,-74.01414589599335,-148.42488400284824,74.4107381068549
648,2018-12-29,3932.49,3963.76,3820.41,3820.41,3820.41,4991655917,BTC,3678.892857,3109.5521204935435,4248.233593506457,0.6242815891485002,64.3163488102667500000,3778.144000,0.01118697434507525,-1,175803189202,3236.76,3820.41,0.1803192080970,2018-12-29,0.08888889,0.011111111,0.9,0.1687556,90,-68.43694428307936,-132.42729605889446,63.9903517758151
649,2018-12-30,3822.38,3901.91,3797.22,3865.95,3865.95,4770578575,BTC,3690.879524,3116.678134747895,4265.080913252105,0.6524469282702609,64.4208643209900000000,3820.090000,0.01200495276289302,1,180573767777,3252.84,3865.95,0.1884845242926,2018-12-30,0.101265825,0.025316456,0.87341774,0.2721519,79,-59.65461317002109,-117.87275948111979,58.21814631109869
650,2018-12-31,3866.84,3868.74,3725.87,3742.70,3742.70,4661840806,BTC,3702.310000,3134.322116643322,4270.297883356678,0.5355553359354291,61.1385960922832500000,3852.747333,-0.02856334025784919,-1,175911926971,3545.86,3742.70,0.0555126259920,2018-12-31,0.05882353,0.0,0.9411765,0.2877157,102,-61.92595360087171,-106.68339830507017,44.75744470419846
651,2019-01-01,3746.71,3850.91,3707.23,3843.52,3843.52,4324200990,BTC,3722.259048,3165.930765529847,4278.587330470153,0.608983271047797,51.8370826882967500000,3872.591333,-0.00750694573741122,1,180236127961,3696.06,3843.52,0.0398965384761,2019-01-01,0.09859155,0.0,0.90140843,0.2497606,71,-54.95716386890763,-96.33815141783766,41.38098754893004
652,2019-01-02,3849.22,3947.98,3817.41,3943.41,3943.41,5244856836,BTC,3743.995238,3190.619871052065,4297.370604947935,0.6801803747606658,50.6251127645467500000,3889.081333,0.01396953736580546,1,185480984797,3745.95,3943.41,0.0527129299644,2019-01-02,0.08045977,0.011494253,0.8965517,0.1894598,87,-40.902560359603285,-85.2510332061908,44.34847284658751
653,2019-01-03,3931.05,3935.69,3826.22,3836.74,3836.74,4530215219,BTC,3768.902857,3250.9214497605954,4286.884264239405,0.5654822181374612,42.7210099076182500000,3895.134000,-0.01499152532364740,-1,180950769578,4134.44,3836.74,-0.0720049148131,2019-01-03,0.09774436,0.0,0.90225565,0.3250301,133,-37.93428056901348,-75.78768267875533,37.85340210974185
654,2019-01-04,3832.04,3865.93,3783.85,3857.72,3857.72,4847965467,BTC,3798.200000,3339.0123744263137,4257.387625573686,0.5648101088587031,46.3295559162652500000,3876.686000,-0.00489232297895677,1,185798735045,3896.54,3857.72,-0.0099626848435,2019-01-04,0.11904762,0.011904762,0.86904764,0.3531429,84,-33.502787507224184,-67.3307036444491,33.82791613722492
655,2019-01-05,3851.97,3904.90,3836.90,3845.19,3845.19,5137609824,BTC,3827.172857,3446.7437286650184,4207.601985334982,0.5236800256053675,47.7241087577560000000,3873.262667,-0.00724780873736700,-1,180661125221,4014.18,3845.19,-0.0420982616624,2019-01-05,0.14492753,0.014492754,0.82608694,0.183942,69,-30.648566019984173,-59.99427611955611,29.34571009957194
656,2019-01-06,3836.52,4093.30,3826.51,4076.63,4076.63,5597027440,BTC,3866.400952,3575.3042219665103,4157.49768203349,0.8610982644425688,57.5654597462555000000,3877.426000,0.05137531960635741,1,186258152661,3998.98,4076.63,0.0194174514501,2019-01-06,0.05952381,0.011904762,0.9285714,0.2130238,84,-9.600631053970119,-49.915547106438915,40.314916052468796
657,2019-01-07,4078.58,4092.61,4020.89,4025.25,4025.25,5228625637,BTC,3889.229048,3630.2968219712757,4148.161274028725,0.7626574414590451,69.9359322273877500000,3879.177333,0.03765557860873384,-1,181029527024,4078.60,4025.25,-0.0130804687883,2019-01-07,0.08510638,0.0,0.9148936,0.2664681,94,2.9006357262856,-39.35231053989401,42.25294626617961
658,2019-01-08,4028.47,4109.02,3996.96,4030.85,4030.85,5306593305,BTC,3905.171429,3655.1176940320365,4155.225163967963,0.7513031269380993,80.2532143818725000000,3875.994000,0.03995259022588786,1,186336120329,3815.49,4030.85,0.0564436022634,2019-01-08,0.08695652,0.010869565,0.8913044,0.2314783,92,13.108743480317116,-28.860099735851787,41.96884321616891
659,2019-01-09,4031.55,4068.40,4022.66,4035.30,4035.30,5115905225,BTC,3918.950000,3673.907349018584,4163.992650981416,0.737407650329461,91.5734452789947500000,3890.648000,0.03717941073055183,1,191452025554,3857.30,4035.30,0.0461462681150,2019-01-09,0.034965035,0.0,0.96503496,0.2827273,143,21.31214706560877,-18.825650375559672,40.137797441168445
660,2019-01-10,4034.41,4064.07,3659.17,3678.92,3678.92,6874143796,BTC,3897.258571,3651.68695812215,4142.83018387785,0.05544826936368288,68.1174733708725000000,3878.756000,-0.05152064218527796,-1,184577881758,3654.83,3678.92,0.0065912778433,2019-01-10,0.07368421,0.010526316,0.9157895,0.1511895,95,-0.9327321432429017,-15.247066729096318,14.314334585853416
661,2019-01-11,3674.02,3713.88,3653.07,3687.37,3687.37,5538712865,BTC,3887.298095,3625.1926396871395,4149.403550312861,0.1186113433591887,46.7959833739482500000,3880.925333,-0.04987350087727132,1,190116594623,3923.92,3687.37,-0.0602841036515,2019-01-11,0.06666667,0.013333334,0.92,0.3353733,75,-17.676352809515265,-15.732923945180108,-1.9434288643351572
662,2019-01-12,3686.97,3698.98,3653.81,3661.30,3661.30,4778170883,BTC,3870.494286,3597.5317458908175,4143.456826109183,0.11680770204526215,24.5093546399510000000,3863.417333,-0.05231568727343596,-1,185338423740,3820.41,3661.30,-0.0416473624559,2019-01-12,0.14035088,0.01754386,0.8245614,0.3214912,57,-32.67279233084491,-19.120897622313073,-13.55189470853184
663,2019-01-13,3658.87,3674.76,3544.93,3552.95,3552.95,4681302466,BTC,3849.254762,3550.124331811492,4148.385192188508,0.004723137306236341,1.9589753132560000000,3845.586667,-0.07609675514823081,-1,180657121274,3865.95,3552.95,-0.0809632819876,2019-01-13,0.078947365,0.0,0.92105263,0.2061711,76,-52.69310486372842,-25.835339070596145,-26.857765793132277
664,2019-01-14,3557.31,3727.84,3552.29,3706.05,3706.05,5651384490,BTC,3831.514286,3545.614225659228,4117.414346340772,0.2805801687301929,7.8400186594145000000,3834.926667,-0.03360603166391656,1,186308505764,3742.70,3706.05,-0.0097923958639,2019-01-14,0.1,0.0076923077,0.8923077,0.2722615,130,-55.56493827423628,-31.781258911324176,-23.783679362912107
665,2019-01-15,3704.22,3720.15,3619.95,3630.68,3630.68,5537192302,BTC,3822.713810,3523.6668440915537,4121.760775908447,0.1789236610098367,11.0196112129545000000,3827.458667,-0.05141235585288164,-1,180771313462,3843.52,3630.68,-0.0553763217051,2019-01-15,0.07070707,0.0,0.9292929,0.3128485,99,-63.19415318817573,-38.06383776669449,-25.130315421481242
666,2019-01-16,3631.51,3685.78,3624.67,3655.01,3655.01,5394457145,BTC,3813.080952,3505.794384906366,4120.367519093634,0.24279553855044786,15.8918614421020000000,3814.891333,-0.04190980005563372,1,186165770607,3943.41,3655.01,-0.0731346727832,2019-01-16,0.06507592,0.008114405,0.9205431,0.2159655,12447,-66.51044232943104,-43.75315867924181,-22.757283650189237
667,2019-01-17,3651.87,3680.14,3621.96,3678.56,3678.56,5464420383,BTC,3814.210952,3509.202467075087,4119.219436924913,0.27762757643710373,21.8883669416437500000,3797.234667,-0.03125291887576671,1,191630190990,3836.74,3678.56,-0.0412277089404,2019-01-17,0.07399591,0.008837301,0.91083556,0.2105089,15163,-66.47208832523529,-48.29694460844051,-18.17514371679478
668,2019-01-18,3677.99,3682.52,3637.08,3657.84,3657.84,5002961727,BTC,3801.540476,3493.5809596036925,4109.499992396308,0.2666893400769691,19.5868660250535000000,3785.308000,-0.03367440641554135,-1,186627229263,3857.72,3657.84,-0.0518129879825,2019-01-18,0.074250154,0.008739425,0.91085786,0.2121872,14303,-67.3373997085564,-52.105035628463696,-15.232364080092708
669,2019-01-19,3652.38,3758.53,3652.38,3728.57,3728.57,5955691380,BTC,3797.167143,3487.7281980597836,4106.606087940217,0.38915884034368575,24.2600443018637500000,3776.698000,-0.01274340707146825,1,192582920643,3845.19,3728.57,-0.0303288003974,2019-01-19,0.07611849,0.009085356,0.9079249,0.2381805,13098,-61.60569324581775,-54.005167151934515,-7.600526093883232
670,2019-01-20,3725.45,3743.39,3583.02,3601.01,3601.01,5582489560,BTC,3784.550952,3465.4377078433363,4103.664196156664,0.21242034706981136,21.6821341277117500000,3760.419333,-0.04239137151569367,-1,187000431083,4076.63,3601.01,-0.1166698964586,2019-01-20,0.07603242,0.010420687,0.90659976,0.2047031,12955,-66.58870734770835,-56.52187519108929,-10.066832156619057
671,2019-01-21,3600.37,3608.84,3558.54,3576.03,3576.03,5004347059,BTC,3776.614286,3445.080579081899,4108.147992918101,0.19749035797203213,16.8818554344310000000,3727.046000,-0.04051895254311323,-1,181996084024,4025.25,3576.03,-0.1116005217067,2019-01-21,0.063725166,0.009965253,0.9206058,0.2018674,15253,-71.7266391101848,-59.562827974908394,-12.163811135276411
672,2019-01-22,3575.08,3620.75,3539.72,3604.58,3604.58,5313623556,BTC,3765.236190,3427.0132656157302,4103.45911438427,0.2624995551492074,14.5504650553162500000,3699.001333,-0.02552616895745250,1,187309707580,4030.85,3604.58,-0.1057518885595,2019-01-22,0.06367041,0.009330442,0.9206255,0.1962926,15219,-72.6571937490462,-62.18170112973596,-10.475492619310238
673,2019-01-23,3605.56,3623.07,3565.31,3585.12,3585.12,5433755649,BTC,3748.174762,3411.557255228944,4084.792268771056,0.2578040970535457,7.8338860278367500000,3669.286000,-0.02293797757928927,-1,181875951931,4035.30,3585.12,-0.1115604787748,2019-01-23,0.063956924,0.010046622,0.9199554,0.1990831,15229,-74.11062323819306,-64.56748555142738,-9.543137686765675
674,2019-01-24,3584.50,3616.09,3569.09,3600.87,3600.87,5262869046,BTC,3736.942857,3397.0127608247503,4076.8729531752497,0.29985170696705793,12.3610924937387500000,3640.324000,-0.01083804628379232,1,187138820977,3678.92,3600.87,-0.0212154654083,2019-01-24,0.0635771,0.010843607,0.9198993,0.2112319,15493,-73.14837428253168,-66.28366329764825,-6.8647109848834305
675,2019-01-25,3607.39,3612.93,3575.60,3599.77,3599.77,5265847539,BTC,3724.659524,3384.417510105408,4064.9015378945924,0.3164695732745527,17.8298241204580000000,3635.047333,-0.00970477954433833,-1,181872973438,3687.37,3599.77,-0.0237567697302,2019-01-25,0.065546684,0.010947397,0.91779125,0.2335074,14524,-71.6486251089209,-67.35665565990277,-4.291969449018126
676,2019-01-26,3599.72,3654.93,3593.35,3602.46,3602.46,5098183235,BTC,3713.100952,3373.5651936531203,4052.636710346879,0.3370702506583036,22.2017501660100000000,3629.386667,-0.00741906814306374,1,186971156673,3661.30,3602.46,-0.0160707945265,2019-01-26,0.08627481,0.008407817,0.89857596,0.2513695,13202,-69.44251250727257,-67.77382702937673,-1.6686854778958349
677,2019-01-27,3604.69,3612.67,3567.25,3583.97,3583.97,5570752966,BTC,3689.640952,3389.845592869492,3989.4363111305083,0.32376152801951935,24.9501765174810000000,3624.231333,-0.01110893022567442,-1,181400403707,3552.95,3583.97,0.0087307730196,2019-01-27,0.07400585,0.008885036,0.91006607,0.2320252,9229,-68.39769479934603,-67.8986005833706,-0.4990942159754326
678,2019-01-28,3584.28,3586.75,3439.23,3470.45,3470.45,6908930483,BTC,3663.221905,3391.140946488086,3935.302863511914,0.14574532143976035,18.1286299965835000000,3618.731333,-0.04097605468739561,-1,174491473224,3706.05,3470.45,-0.0635717273107,2019-01-28,0.043010753,0.010752688,0.94623655,0.2183441,93,-75.85537101337059,-69.48995466937059,-6.365416343999996
679,2019-01-29,3468.87,3476.07,3400.82,3448.12,3448.12,5897159493,BTC,3635.472857,3405.217151129951,3865.7285628700492,0.09316348688935877,11.4636715636032500000,3601.536000,-0.04259738067313502,-1,168594313731,3630.68,3448.12,-0.0502825916908,2019-01-29,0.023809524,0.0,0.97619045,0.2241667,84,-82.61514159685612,-72.1149920548677,-10.50014954198842
680,2019-01-30,3443.90,3495.17,3429.39,3486.18,3486.18,5955112627,BTC,3609.324286,3458.8873491033146,3759.7612228966855,0.09071126898651505,7.8085457123517500000,3591.902667,-0.02943361132006977,1,174549426358,3655.01,3486.18,-0.0461913920892,2019-01-30,0.07317073,0.0,0.9268293,0.2194634,82,-83.93364969962249,-74.47872358381866,-9.45492611580383
681,2019-01-31,3485.41,3504.80,3447.92,3457.79,3457.79,5831198271,BTC,3598.794286,3438.2035407409494,3759.3850312590503,0.060982528063667274,4.2547691210555000000,3578.754667,-0.03380077100993411,-1,168718228087,3678.56,3457.79,-0.0600153320865,2019-01-31,0.050632913,0.0,0.93670887,0.2597468,79,-86.27488938470015,-76.83795674399497,-9.43693264070518
682,2019-02-01,3460.55,3501.95,3431.59,3487.95,3487.95,5422926707,BTC,3589.298095,3427.1290439922254,3751.4671460077748,0.1875233148057903,7.8053128899982500000,3566.047333,-0.02190025137279915,1,174141154794,3657.84,3487.95,-0.0464454432124,2019-02-01,0.046875,0.0,0.953125,0.2675156,64,-84.7200784327274,-78.41438108174145,-6.305697350985952
683,2019-02-02,3484.63,3523.29,3467.57,3521.06,3521.06,5071623601,BTC,3582.620000,3421.3564685987553,3743.8835314012445,0.3091322958603992,14.3073631663397500000,3556.928667,-0.01008416821309282,1,179212778395,3728.57,3521.06,-0.0556540443119,2019-02-02,0.035714287,0.0,0.96428573,0.3269643,56,-79.89519716342966,-78.7105442980791,-1.1846528653505572
684,2019-02-03,3516.14,3521.39,3447.92,3464.01,3464.01,5043937584,BTC,3578.384762,3409.363476994939,3747.4060470050613,0.1616557435456277,13.4535891339147500000,3539.291333,-0.02127017131878474,-1,174168840811,3601.01,3464.01,-0.0380448818526,2019-02-03,0.016129032,0.0,0.983871,0.2567258,62,-79.75553010442582,-78.91954145934845,-0.8359886450773644
685,2019-02-04,3467.21,3476.22,3442.59,3459.15,3459.15,5332718886,BTC,3566.627619,3400.5814502510934,3732.6737877489063,0.17636224367655695,14.3540129382920000000,3529.834000,-0.02002473770721229,-1,168836121925,3576.03,3459.15,-0.0326842895613,2019-02-04,0.036585364,0.0121951215,0.9512195,0.1929878,82,-79.1249017236737,-78.96061351221351,-0.1642882114601889
686,2019-02-05,3454.95,3478.15,3451.94,3466.36,3466.36,5227549545,BTC,3558.802857,3389.970529628391,3727.6351843716093,0.22622880215194738,13.7179521042847500000,3522.522667,-0.01594387667853721,1,174063671470,3604.58,3466.36,-0.0383456602434,2019-02-05,0.017857144,0.008928572,0.96428573,0.2510179,112,-77.15395468207407,-78.59928174618562,1.4453270641115523
687,2019-02-06,3469.09,3469.09,3398.57,3413.77,3413.77,5482196038,BTC,3547.315238,3373.2295028441235,3721.4009731558767,0.11643830874360965,7.2159018279432500000,3509.802000,-0.02736108760551165,-1,168581475432,3585.12,3413.77,-0.0477947739546,2019-02-06,0.07017544,0.0,0.92105263,0.235886,114,-78.92573173287701,-78.66457174352391,-0.2611599893531036
688,2019-02-07,3414.93,3427.95,3394.22,3399.47,3399.47,5004962683,BTC,3534.025238,3359.409581929985,3708.6408940700153,0.11471026989112545,4.6769142272785000000,3497.425333,-0.02800784110406625,-1,163576512749,3600.87,3399.47,-0.0559309278036,2019-02-07,0.04464286,0.017857144,0.9375,0.2095536,112,-80.55517834837292,-79.04269306449372,-1.512485283879201
689,2019-02-08,3401.38,3695.61,3391.02,3666.78,3666.78,7735623101,BTC,3534.450952,3358.52877467096,3710.3731293290402,0.8761010976816623,27.9144829349355000000,3501.819333,0.04710713241127680,1,171312135850,3599.77,3666.78,0.0186150781856,2019-02-08,0.07368421,0.010526316,0.9157895,0.3243474,95,-59.58992793774087,-75.15214003914315,15.562212101402281
690,2019-02-09,3671.59,3679.94,3646.56,3671.20,3671.20,6158833645,BTC,3531.719048,3367.034846947833,3696.4032490521668,0.9234800639917385,50.0000000000000000000,3506.581333,0.04694562919467866,-1,165153302205,3602.46,3671.20,0.0190814054840,2019-02-09,0.101265825,0.0,0.886076,0.2682658,79,-42.13248185604607,-68.54820840252374,26.41572654647767
691,2019-02-10,3673.20,3695.04,3640.98,3690.19,3690.19,6282256903,BTC,3535.965714,3359.592519146425,3712.338908853575,0.9372101047668752,75.0000000000000000000,3512.430000,0.05060883775619728,1,171435559108,3583.97,3690.19,0.0296375248677,2019-02-10,0.051948052,0.0,0.9480519,0.2435325,77,-26.45998157145914,-60.13056303631082,33.67058146485168
692,2019-02-11,3695.61,3695.61,3642.29,3648.43,3648.43,6277056434,BTC,3539.413333,3357.0231028522935,3721.8035631477064,0.7988555552337263,96.4089157952670000000,3516.727333,0.03745034929610222,-1,165158502674,3470.45,3648.43,0.0512844155657,2019-02-11,0.16666667,0.022727273,0.8030303,0.2601515,132,-17.210700931723295,-51.54659061539332,34.335889683670025
693,2019-02-12,3642.75,3668.59,3618.56,3653.53,3653.53,6480384532,BTC,3541.744286,3354.6652656293095,3728.8233063706907,0.7987660342097702,93.2563979086407500000,3528.932667,0.03530737045938655,1,171638887206,3448.12,3653.53,0.0595715926360,2019-02-12,0.1764706,0.039215688,0.78431374,0.3990735,204,-9.361142585129528,-43.10950100934057,33.74835842421104
694,2019-02-13,3653.60,3669.75,3617.25,3632.07,3632.07,6438903823,BTC,3543.980000,3353.6302615709706,3734.3297384290295,0.7313898635401694,88.2584617501377500000,3541.196000,0.02566195149887213,-1,165199983383,3486.18,3632.07,0.0418480973444,2019-02-13,0.20467836,0.0116959065,0.7777778,0.3368012,171,-4.816432853922379,-35.45088737825693,30.63445452433455
695,2019-02-14,3631.17,3646.26,3607.70,3616.88,3616.88,6271044418,BTC,3544.742381,3353.310488787154,3736.174273212846,0.6884158855824112,81.9542859108422500000,3549.909333,0.01886545844352696,-1,158928938965,3457.79,3616.88,0.0460091561373,2019-02-14,0.22727273,0.025974026,0.73376626,0.3138312,154,-2.4126126046412537,-28.84323242353379,26.430619818892538
696,2019-02-15,3617.37,3647.80,3608.21,3620.81,3620.81,6091952231,BTC,3545.744286,3352.887857269047,3738.6007147309533,0.6946155347113713,79.5791483214090000000,3560.777333,0.01685942741873773,1,165020891196,3487.95,3620.81,0.0380911423616,2019-02-15,0.23308271,0.037593983,0.7293233,0.2878045,133,-0.18827921725915076,-23.112241782278865,22.923962565019714
697,2019-02-16,3615.27,3652.84,3615.27,3629.79,3629.79,5934744052,BTC,3547.045714,3352.2229985306344,3741.8684294693653,0.7123579013890993,77.5376651073197500000,3570.233333,0.01668144948665180,1,170955635248,3521.06,3629.79,0.0308799054830,2019-02-16,0.3046875,0.0390625,0.65625,0.2019688,128,2.272931034589419,-18.03520721890521,20.30813825349463
698,2019-02-17,3633.36,3680.54,3619.18,3673.84,3673.84,7039512503,BTC,3551.325238,3349.281559789664,3753.368916210336,0.8031888032459426,81.1296092460097500000,3580.418667,0.02609229302177582,1,177995147751,3464.01,3673.84,0.0605743055014,2019-02-17,0.22758621,0.020689655,0.737931,0.315131,145,7.68928743094375,-12.890308288935417,20.579595719879165
699,2019-02-18,3671.37,3936.67,3669.98,3915.71,3915.71,9908216640,BTC,3572.528095,3319.189228686989,3825.8669613130114,1.177317914133206,87.4337850853052500000,3610.532000,0.08452438587997558,1,187903364391,3459.15,3915.71,0.1319861815764,2019-02-18,0.16019417,0.009708738,0.8252427,0.3531699,206,31.13971722944325,-4.0843031852596825,35.224020414702935
700,2019-02-19,3911.66,4010.88,3908.15,3947.09,3947.09,9933626655,BTC,3596.288571,3301.715528289998,3890.861613710002,1.095440481879656,93.4000068794715000000,3643.061333,0.08345417197509477,1,197836991046,3466.36,3947.09,0.1386843836186,2019-02-19,0.16551724,0.03448276,0.79310346,0.3051448,145,51.66094037949961,7.064745527692178,44.596194851807425
701,2019-02-20,3946.69,4000.49,3926.25,3999.82,3999.82,8693373948,BTC,3620.747619,3282.511914621839,3958.9833233781615,1.0603671878711267,98.5940079801870000000,3678.625333,0.08731377564294069,1,206530364994,3413.77,3999.82,0.1716723739443,2019-02-20,0.19548872,0.037593983,0.7669173,0.2604286,133,71.35647486595963,19.923091395345672,51.433383470613954
702,2019-02-21,4000.26,4010.01,3940.11,3954.12,3954.12,7775128102,BTC,3644.382381,3285.2533579509154,4003.5114040490844,0.9312344577030554,98.0969434496542500000,3714.648667,0.06446675162779264,-1,198755236892,3399.47,3954.12,0.1631577863608,2019-02-21,0.21787709,0.05027933,0.7318436,0.2998994,179,82.32868593237708,32.40421030275196,49.92447562962512
703,2019-02-22,3952.41,4006.54,3950.82,4005.53,4005.53,7826525254,BTC,3669.029048,3284.8238509552557,4053.234245044744,0.9379182720435868,98.0969434496542500000,3755.052667,0.06670407986583907,1,206581762146,3666.78,4005.53,0.0923835081461,2019-02-22,0.19480519,0.032467533,0.77272725,0.2020974,154,94.08801157207881,44.740970556617334,49.34704101546148
704,2019-02-23,3998.92,4166.29,3968.73,4142.53,4142.53,8922258316,BTC,3698.622857,3269.2081820694443,4128.037531930556,1.0168746772240465,98.0969434496542500000,3786.769333,0.09394833318726467,1,215504020462,3671.20,4142.53,0.1283858139028,2019-02-23,0.15286624,0.012738854,0.83439493,0.2660127,157,113.15770531746239,58.42431750878636,54.73338780867603
705,2019-02-24,4145.46,4210.64,3793.71,3810.43,3810.43,10794227451,BTC,3715.119048,3297.0932475089417,4133.144848491058,0.6140012792129547,82.3022131157820000000,3796.051333,0.00378779572209752,-1,204709793011,3690.19,3810.43,0.0325836881028,2019-02-24,0.18181819,0.022727273,0.7878788,0.3101894,132,100.3164943736183,66.80275288175275,33.513741491865545
706,2019-02-25,3807.00,3913.71,3807.00,3882.70,3882.70,9318796067,BTC,3735.288095,3328.4101104582433,4142.1660795417565,0.6811500137639808,71.8477123561305000000,3808.885333,0.01937959810983892,1,214028589078,3648.43,3882.70,0.0642111812478,2019-02-25,0.17757009,0.009345794,0.8130841,0.2940935,107,94.87763686065136,72.41772967753248,22.459907183118887
707,2019-02-26,3878.70,3891.58,3837.99,3854.36,3854.36,7931218996,BTC,3753.764286,3363.2683173359724,4144.260254664028,0.6288050608360436,58.1423000095120000000,3822.614000,0.00830478829408358,-1,206097370082,3653.53,3854.36,0.0549687562440,2019-02-26,0.23178808,0.046357617,0.7152318,0.2339934,151,87.27445633783464,75.38907500959291,11.88538132824172
708,2019-02-27,3857.48,3888.80,3787.06,3851.05,3851.05,8301309684,BTC,3774.587143,3414.809855048531,4134.364430951469,0.6062641522417532,44.2794635213545000000,3835.782000,0.00398041390256276,-1,197796060398,3632.07,3851.05,0.0602906882301,2019-02-27,0.25203252,0.008130081,0.7398374,0.2583496,123,80.05892223776027,76.3230444552264,3.7358777825338763
709,2019-02-28,3848.26,3906.06,3845.82,3854.79,3854.79,8399767798,BTC,3796.269048,3479.079544018247,4113.458551981754,0.5922491937238977,46.3892323789592500000,3850.630000,0.00108034269716903,1,206195828196,3616.88,3854.79,0.0657776868461,2019-02-28,0.168,0.0,0.832,0.303808,125,73.7917211936824,75.8167798029176,-2.025058609235188
710,2019-03-01,3853.76,3907.80,3851.69,3859.58,3859.58,7661247975,BTC,3805.450000,3492.8746705832336,4118.025329416766,0.5865871278149194,45.1882717099640000000,3866.810000,-0.00186975827620183,1,213857076171,3620.81,3859.58,0.0659438081534,2019-03-01,0.23853211,0.018348623,0.74311924,0.2274862,109,68.42269791192757,74.33796342471959,-5.915265512792018
711,2019-03-02,3855.32,3874.61,3832.13,3864.42,3864.42,7578786076,BTC,3814.650952,3507.3422234611076,4121.959680538893,0.5809756498564621,45.3336926379297500000,3883.050667,-0.00479794589298878,1,221435862247,3629.79,3864.42,0.0646401031465,2019-03-02,0.1724138,0.00862069,0.8103448,0.229319,116,63.8225492107008,72.23488058191583,-8.412331371215032
712,2019-03-03,3862.27,3875.48,3836.91,3847.18,3847.18,7253558152,BTC,3822.126667,3519.9388872779646,4124.314446722035,0.5414532530452504,43.4425126119735000000,3897.543333,-0.01292181476818490,-1,214182304095,3673.84,3847.18,0.0471822398362,2019-03-03,0.18248175,0.03649635,0.7810219,0.2803139,137,58.115850949503965,69.41107465543347,-11.295223705929502
713,2019-03-04,3845.09,3867.38,3733.75,3761.56,3761.56,9029175788,BTC,3827.513810,3534.435113164069,4120.592506835931,0.38748105762712265,32.1274740882410000000,3903.391333,-0.03633541218399790,-1,205153128307,3915.71,3761.56,-0.0393670624229,2019-03-04,0.13533835,0.02255639,0.84210527,0.2193233,133,46.15241668845829,64.75934306203843,-18.606926373580137
714,2019-03-05,3759.83,3903.92,3745.18,3896.38,3896.38,10174126415,BTC,3839.078095,3555.832825975499,4122.323364024501,0.6011524485428275,29.5331453863925000000,3902.102667,-0.00146655982386022,1,215327254722,3947.09,3896.38,-0.0128474395061,2019-03-05,0.06918239,0.0,0.9245283,0.3015975,159,47.008273986061795,61.2091292468431,-14.200855260781303
715,2019-03-06,3897.08,3919.51,3871.46,3903.94,3903.94,9175291529,BTC,3852.024286,3584.078602506391,4119.969969493609,0.5968773098396237,27.4363921794842500000,3899.226000,0.00120895788035882,1,224502546251,3999.82,3903.94,-0.0239710786985,2019-03-06,0.07926829,0.0,0.9207317,0.3161829,164,47.746187549868864,58.51654090744825,-10.770353357579388
716,2019-03-07,3903.38,3939.37,3894.11,3911.48,3911.48,9584165519,BTC,3866.052857,3619.848155083659,4112.257558916341,0.5922548242304406,28.0284536840172500000,3893.336667,0.00466009866390011,1,234086711770,3954.12,3911.48,-0.0107836889118,2019-03-07,0.15686275,0.019607844,0.8235294,0.3207843,153,48.381690341457215,56.48957079425005,-8.107880452792834
717,2019-03-08,3913.23,3950.43,3875.23,3901.13,3901.13,10638638944,BTC,3879.401429,3660.11702387408,4098.68583412592,0.5495442687488941,37.1873113368507500000,3889.804000,0.00291171483190413,-1,223448072826,4005.53,3901.13,-0.0260639665662,2019-03-08,0.079943895,0.004207574,0.9130435,0.2792034,713,47.502592068868125,54.69217504917367,-7.189582980305545
718,2019-03-09,3894.55,3987.24,3892.39,3963.31,3963.31,10796103518,BTC,3895.283333,3705.6172570313825,4084.9494089686173,0.6793327210799045,41.5793894532377500000,3886.989333,0.01963490518279742,1,234244176344,4142.53,3963.31,-0.0432634163180,2019-03-09,0.11363637,0.007575758,0.8787879,0.3128258,132,51.23272770067024,54.00028557947298,-2.767557878802741
719,2019-03-10,3966.17,3966.17,3924.38,3951.60,3951.60,9713267607,BTC,3908.510000,3747.0623738173895,4069.957626182611,0.6334488496946412,55.7850807950317500000,3874.260667,0.01996234627647990,-1,224530908737,3810.43,3951.60,0.0370483121328,2019-03-10,0.119266056,0.0091743115,0.853211,0.2778257,109,52.63721883440985,53.72767223046036,-1.0904533960505063
720,2019-03-11,3953.74,3966.38,3889.24,3905.23,3905.23,10125901903,BTC,3908.010952,3746.5920135937818,4069.4298904062184,0.4913859178252007,63.7500097823077500000,3880.580667,0.00635197026301116,-1,214405006834,3882.70,3905.23,0.0058026630953,2019-03-11,0.11392405,0.012658228,0.87341774,0.2528544,158,49.438717941079176,52.869881372584125,-3.431163431504949
721,2019-03-12,3903.76,3926.89,3863.56,3909.16,3909.16,9809887079,BTC,3906.204762,3745.776579984614,4066.632944015386,0.5092104702642475,72.8811149547530000000,3882.344667,0.00690699443249612,1,224214893913,3854.36,3909.16,0.0142176651896,2019-03-12,0.15079366,0.007936508,0.84126985,0.318246,126,46.6828700281726,51.63247910370182,-4.949609075529217
722,2019-03-13,3913.05,3926.60,3891.90,3906.72,3906.72,9469184841,BTC,3901.771429,3747.168895219248,4056.3739627807518,0.5160041717266344,77.6294919454772500000,3885.835333,0.00537456305022486,-1,214745709072,3851.05,3906.72,0.0144557977694,2019-03-13,0.12931034,0.01724138,0.8534483,0.2935431,116,43.79708753198429,50.06540078935832,-6.268313257374032
723,2019-03-14,3905.58,3946.50,3901.30,3924.37,3924.37,10480789570,BTC,3900.354762,3747.228739440927,4053.480784559073,0.5784165800125035,74.2552664188352500000,3890.723333,0.00864792073870137,1,225226498642,3854.79,3924.37,0.0180502699239,2019-03-14,0.1119403,0.0074626864,0.8731343,0.309791,134,42.44501192919324,48.54132301732531,-6.096311088132069
724,2019-03-15,3926.66,3968.54,3914.02,3960.91,3960.91,9394210605,BTC,3898.230000,3750.0758956356594,4046.3841043643406,0.7115364952895843,81.1548946716232500000,3897.798000,0.01619170618898157,1,234620709247,3859.58,3960.91,0.0262541520062,2019-03-15,0.090277776,0.013888889,0.8958333,0.2833819,144,43.81686139220028,47.59643069230031,-3.779569300100029
725,2019-03-16,3963.90,4077.04,3961.66,4048.73,4048.73,9856166973,BTC,3893.763333,3773.5161044525894,4014.0105615474104,1.1443668967343419,87.8649318463445000000,3910.408000,0.03537277951559019,1,244476876220,3864.42,4048.73,0.0476940912220,2019-03-16,0.13675214,0.017094018,0.84615386,0.2976581,117,51.397918818861854,48.35672831761262,3.0411905012492326
726,2019-03-17,4047.72,4054.12,4006.41,4025.23,4025.23,8221625400,BTC,3903.991905,3777.154274366335,4030.829535633665,0.9779263629977546,92.8314969061627500000,3921.128667,0.02654881842468242,-1,236255250820,3847.18,4025.23,0.0462806523220,2019-03-17,0.125,0.015625,0.859375,0.3331172,128,54.877118582555795,49.660806370601264,5.216312211954531
727,2019-03-18,4029.97,4071.56,4009.12,4032.51,4032.51,9646954186,BTC,3911.125714,3772.970900609886,4049.2805273901135,0.9393053091000251,96.2447201397357500000,3933.484000,0.02517513735914523,1,245902205006,3761.56,4032.51,0.0720312848924,2019-03-18,0.121212125,0.007575758,0.8712121,0.2724167,132,57.55834781527801,51.24031465953662,6.318033155741389
728,2019-03-19,4032.69,4082.22,4023.81,4071.19,4071.19,9344919956,BTC,3921.450952,3769.402821343322,4073.499082656678,0.9924067377655171,96.5421179092525000000,3954.126000,0.02960553103264792,1,255247124962,3896.38,4071.19,0.0448647205868,2019-03-19,0.10967742,0.012903226,0.87741935,0.2661871,155,62.08867444700854,53.40998661703102,8.678687829977527
729,2019-03-20,4070.79,4089.46,4031.11,4087.48,4087.48,10175916388,BTC,3932.709524,3768.0640523372554,4097.354995662744,0.9700113353771077,96.5421179092525000000,3966.866000,0.03040536282294386,1,265423041350,3903.94,4087.48,0.0470140422240,2019-03-20,0.095744684,0.06382979,0.84042555,0.203016,188,66.22999959213075,55.97398921205097,10.256010380079786
730,2019-03-21,4083.95,4097.36,4005.15,4029.33,4029.33,10831212662,BTC,3941.020952,3775.277750521959,4106.7641534780405,0.7664032286467574,90.7867638489757500000,3975.225333,0.01361046543723060,-1,254591828688,3911.48,4029.33,0.0301292605357,2019-03-21,0.08759124,0.05109489,0.8540146,0.273073,137,64.08112328597736,57.595416026836254,6.485707259141101
731,2019-03-22,4028.51,4053.91,4021.54,4023.97,4023.97,9252935969,BTC,3948.849048,3783.7338764493807,4113.964219550619,0.7274804649824984,83.6785618459887500000,3982.724667,0.01035605934343138,-1,245338892719,3901.13,4023.97,0.0314883123608,2019-03-22,0.06521739,0.028985508,0.9057971,0.3198696,138,61.2396831796068,58.324269457390365,2.915413722216435
732,2019-03-23,4022.71,4049.88,4015.96,4035.83,4035.83,9578850549,BTC,3957.011429,3792.479725272638,4121.543132727363,0.7395239616876699,76.5935138350147500000,3991.704667,0.01105425793766521,1,254917743268,3963.31,4035.83,0.0182978369090,2019-03-23,0.10377359,0.028301887,0.8679245,0.2791698,106,59.26169240476247,58.51175404686479,0.7499383578976833
733,2019-03-24,4035.16,4040.70,4006.19,4022.17,4022.17,9144851065,BTC,3965.344286,3806.550118780743,4124.138453219257,0.6789288454201762,67.6346660983892500000,3995.628667,0.00664259249594577,-1,245772892203,3951.60,4022.17,0.0178585889260,2019-03-24,0.12931034,0.0,0.87068963,0.3679569,116,55.94695100105537,57.99879343770291,-2.05184243664754
734,2019-03-25,4024.11,4038.84,3934.03,3963.07,3963.07,10359818883,BTC,3974.940000,3846.393166044434,4103.486833955566,0.45383005697323153,58.3700030511782500000,3996.393333,-0.00833835166444564,-1,235413073320,3905.23,3963.07,0.0148109074241,2019-03-25,0.10958904,0.0,0.89041096,0.2470411,146,47.99782937705595,55.998600625573516,-8.000771248517566
735,2019-03-26,3969.23,3985.08,3944.75,3985.08,3985.08,10707678815,BTC,3979.163810,3855.7312886004606,4102.596331399539,0.5239652805148897,52.7278353156660000000,4001.716667,-0.00415738253964695,1,246120752135,3909.16,3985.08,0.0194210520930,2019-03-26,0.09467456,0.01183432,0.89349115,0.3459349,169,42.978684749968124,53.39461745045244,-10.415932700484312
736,2019-03-27,3984.24,4087.07,3977.81,4087.07,4087.07,10897131934,BTC,3987.884286,3860.946442695266,4114.822129304734,0.8906861477151846,59.7561783034047500000,4013.577333,0.01831101306949702,1,257017884069,3906.72,4087.07,0.0461640455420,2019-03-27,0.094339624,0.0,0.8993711,0.2842893,159,46.69247531563997,52.05418902348995,-5.3617137078499795
737,2019-03-28,4087.58,4094.90,4040.27,4069.11,4069.11,9353915899,BTC,3995.390476,3868.7864624022964,4121.994489597704,0.7911421285357135,65.8994414652035000000,4024.403333,0.01110889324472190,-1,247663968170,3924.37,4069.11,0.0368823530911,2019-03-28,0.112443775,0.011994003,0.8650675,0.2493358,1334,47.63732575523318,51.1708163698386,-3.5334906146054195
738,2019-03-29,4068.30,4113.50,4034.10,4098.37,4098.37,10918665557,BTC,4004.782857,3878.2837874156176,4131.281926584383,0.86991237685575,82.9652850866027500000,4036.003333,0.01545258064830245,1,258582633727,3960.91,4098.37,0.0347041462694,2019-03-29,0.09195402,0.01724138,0.8908046,0.3037356,174,50.16884874060861,50.97042284399261,-0.8015741033839987
739,2019-03-30,4092.14,4296.81,4053.91,4106.66,4106.66,9732688060,BTC,4011.609048,3879.1775615770553,4144.040534422944,0.8588684027015961,97.1277104019380000000,4045.720000,0.01506283183215843,1,268315321787,4048.73,4106.66,0.0143081904696,2019-03-30,0.10236221,0.0,0.8976378,0.3010945,127,52.241821464301665,51.224702568054425,1.01711889624724
740,2019-03-31,4105.46,4113.02,4094.10,4105.40,4105.40,9045122443,BTC,4018.932857,3883.4634892236854,4154.402224776314,0.8191390954993365,96.9650408169135000000,4049.498000,0.01380467406083421,-1,259270199344,4025.23,4105.40,0.0199168743153,2019-03-31,0.10559006,0.0062111802,0.88819873,0.3039565,161,53.17008417985244,51.61377889041403,1.5563052894384057
741,2019-04-01,4105.36,4164.95,4096.90,4158.18,4158.18,10157794171,BTC,4030.978095,3893.0111916326996,4168.9449983673,0.9609870262194657,99.7806253917402500000,4058.361333,0.02459580574759039,1,269427993515,4032.51,4158.18,0.0311642128600,2019-04-01,0.11518325,0.015706806,0.8691099,0.3482147,191,57.50179902331956,52.79138291699514,4.710416106324423
742,2019-04-02,4156.92,4905.95,4155.32,4879.88,4879.88,21315047816,BTC,4077.202857,3688.333257563744,4466.072456436256,1.5320646614747466,99.7806253917402500000,4114.852667,0.18591852367772758,1,290743041331,4071.19,4879.88,0.1986372534812,2019-04-02,0.0779661,0.013559322,0.90847456,0.2961322,295,117.81181151864848,65.79546863732583,52.01634288132266
743,2019-04-03,4879.96,5307.00,4876.62,4973.02,4973.02,22899891582,BTC,4127.979048,3584.7702255788336,4671.187870421167,1.2778232947630717,99.7806253917402500000,4174.974667,0.19114974260992324,1,313642932913,4087.48,4973.02,0.2166469316058,2019-04-03,0.083333336,0.013157895,0.8947368,0.3078026,228,171.1506325731798,86.86650142449663,84.28413114868316
744,2019-04-04,4971.31,5063.16,4836.79,4922.80,4922.80,18251810240,BTC,4175.523333,3540.1977181115926,4810.848947888408,1.0881052561773827,98.7568691519382500000,4230.662667,0.16360021762047047,-1,295391122673,4029.33,4922.80,0.2217415798656,2019-04-04,0.12182741,0.005076142,0.87309647,0.2996294,197,206.98371878316084,110.88994489622951,96.09377388693133
745,2019-04-05,4922.81,5053.51,4919.49,5036.68,5036.68,16837325387,BTC,4226.750476,3497.556882652494,4955.944069347506,1.0553597366934204,98.7568691519382500000,4297.819333,0.17191524579146380,1,312228448060,4023.97,5036.68,0.2516693712925,2019-04-05,0.09259259,0.0046296297,0.8981481,0.3466296,216,241.7837297022843,137.06870185744046,104.71502784484383
746,2019-04-06,5036.79,5205.82,4992.22,5059.82,5059.82,16929795194,BTC,4274.897619,3465.916910975272,5083.878327024729,0.9851304692521831,98.7568691519382500000,4366.876000,0.15868185861013686,1,329158243254,4035.83,5059.82,0.2537247604582,2019-04-06,0.0625,0.013888889,0.9166667,0.3394236,144,268.1392513089786,163.2828117477481,104.8564395612305
747,2019-04-07,5062.79,5235.19,5050.41,5198.90,5198.90,16655416140,BTC,4330.786667,3436.571915246635,5225.001418753365,0.985405396912662,98.7568691519382500000,4444.414000,0.16976051285951309,1,345813659394,4022.17,5198.90,0.2925609807641,2019-04-07,0.104166664,0.0069444445,0.8888889,0.3100903,144,296.8271471397629,189.9916788261511,106.83546831361184
748,2019-04-08,5199.84,5318.84,5148.21,5289.77,5289.77,17154113634,BTC,4390.656190,3415.6168454097165,5365.6955345902825,0.961065399559755,100.0000000000000000000,4528.920667,0.16799793790691278,1,362967773028,3963.07,5289.77,0.3347657245519,2019-04-08,0.055555556,0.011904762,0.9285714,0.3558333,252,323.1696621394958,216.62727548882006,106.54238665067575
749,2019-04-09,5289.92,5289.92,5167.42,5204.96,5204.96,14722104361,BTC,4444.645238,3419.6252867479466,5469.665189252053,0.8708780307501732,98.3749013175542500000,4611.713333,0.12863910311920509,-1,348245668667,3985.08,5204.96,0.3061117970028,2019-04-09,0.08292683,0.004878049,0.91219515,0.299122,205,333.36006947957776,239.97383428697162,93.38623519260614
750,2019-04-10,5204.11,5421.65,5193.38,5324.55,5324.55,15504590933,BTC,4503.553333,3424.0051453152937,5583.101520684706,0.8802501251754133,98.3749013175542500000,4701.011333,0.13263926054015322,1,363750259600,4087.07,5324.55,0.3027792526186,2019-04-10,0.04296875,0.01171875,0.9453125,0.29925,256,347.08497472346335,261.39606237426995,85.6889123491934
751,2019-04-11,5325.08,5354.23,5017.30,5064.49,5064.49,16555616019,BTC,4552.846667,3469.716283817377,5635.977050182622,0.736187323771959,93.1962388565845000000,4766.172667,0.06259054252597433,-1,347194643581,4069.11,5064.49,0.2446186021022,2019-04-11,0.05670103,0.005154639,0.9381443,0.2555619,194,333.13719421968835,275.74428874335365,57.392905476334704
752,2019-04-12,5061.20,5103.27,4955.85,5089.54,5089.54,13675206312,BTC,4603.588095,3524.688860008723,5682.487329991277,0.7252072710960487,88.4047319000202500000,4834.201333,0.05281920412726013,1,360869849893,4098.37,5089.54,0.2418449285936,2019-04-12,0.09375,0.015625,0.8854167,0.2955625,192,320.4113012982725,284.67769125433745,35.73361004393507
753,2019-04-13,5088.85,5127.12,5061.59,5096.59,5096.59,10823289598,BTC,4654.100476,3587.5886001640815,5720.612351835918,0.7074470683475431,85.3552622356670000000,4900.749333,0.03996137196433915,1,371693139491,4106.66,5096.59,0.2410547744396,2019-04-13,0.083333336,0.017857144,0.89880955,0.2445893,168,307.35185469262524,289.212523941995,18.139330750630222
754,2019-04-14,5095.76,5184.02,5053.57,5167.72,5167.72,10391952498,BTC,4708.650476,3660.870246897041,5756.430705102959,0.7190676590610159,82.1392920925345000000,4971.486667,0.03947176089248476,1,382085091989,4105.40,5167.72,0.2587616310226,2019-04-14,0.11309524,0.0,0.8869048,0.2331786,168,299.2916973270303,291.2283586190021,8.063338708028198
755,2019-04-15,5167.32,5196.61,5024.07,5067.11,5067.11,12290155061,BTC,4761.223810,3760.846184970808,5761.601435029193,0.6528853616608392,81.7999799828277500000,5035.600667,0.00625731369178882,-1,369794936928,4158.18,5067.11,0.2185884208957,2019-04-15,0.15315315,0.009009009,0.8333333,0.2960631,222,281.54015868074293,289.2907186313503,-7.7505599506073395
756,2019-04-16,5066.58,5238.95,5055.19,5235.56,5235.56,11618660197,BTC,4820.770476,3866.6310044241463,5774.909947575853,0.717363150963106,81.5883385372060000000,5107.426000,0.02508778394439782,1,381413597125,4879.88,5235.56,0.0728870382059,2019-04-16,0.13397129,0.028708134,0.83253586,0.2309091,209,277.86143001278924,287.0048609076381,-9.143430894848848
757,2019-04-17,5236.14,5274.28,5219.21,5251.94,5251.94,12438480677,BTC,4876.240476,3966.8575988030248,5785.623353196976,0.7065683956784143,81.7445496966995000000,5132.230000,0.02332514326131136,1,393852077802,4973.02,5251.94,0.0560866435285,2019-04-17,0.14798206,0.013452915,0.83856505,0.3094978,223,273.11938983119853,284.2277666923502,-11.108376861151669
758,2019-04-18,5251.48,5319.99,5250.51,5298.39,5298.39,13256489918,BTC,4934.777619,4087.4667949713025,5782.088443028698,0.7145684739816831,83.3326418062290000000,5153.921333,0.02803082500987797,1,407108567720,4922.80,5298.39,0.0762960104006,2019-04-18,0.07582939,0.0,0.9241706,0.3368863,211,269.9970576110791,281.381624876096,-11.384567265016926
759,2019-04-19,5298.15,5336.68,5233.33,5303.81,5303.81,13780238655,BTC,4992.179524,4223.1423592939955,5761.216688706005,0.7026108036788661,87.0494561309612500000,5179.322000,0.02403557840196072,1,420888806375,5036.68,5303.81,0.0530369211465,2019-04-19,0.09793814,0.0,0.9020619,0.3355052,194,264.9062610555875,278.0865521119943,-13.180291056406816
760,2019-04-20,5304.16,5358.49,5295.88,5337.89,5337.89,13169647522,BTC,5050.809524,4384.435050465002,5717.1839975349985,0.7154047666900333,92.0526045331472500000,5199.402667,0.02663523905908709,1,434058453897,5059.82,5337.89,0.0549565004289,2019-04-20,0.076712325,0.002739726,0.9150685,0.3719315,365,260.61750294452577,274.5927422785006,-13.975239333974855
761,2019-04-21,5335.88,5359.92,5257.34,5314.53,5314.53,13731844223,BTC,5108.387143,4593.332740003856,5623.441545996144,0.7001175563210777,94.4348973459100000000,5216.383333,0.01881507947836241,-1,420326609674,5198.90,5314.53,0.0222412433399,2019-04-21,0.08053691,0.013422819,0.8993289,0.343604,149,252.42388900629157,270.15897162405884,-17.73508261776726
762,2019-04-22,5312.49,5422.69,5280.28,5399.37,5399.37,14601631648,BTC,5167.491429,4872.5938363827845,5462.389021617215,0.893151007002259,96.0627753795130000000,5229.748000,0.03243406756883888,1,434928241322,5289.77,5399.37,0.0207192373203,2019-04-22,0.06329114,0.025316456,0.9113924,0.305481,237,249.8956286386583,266.1063030269787,-16.2106743883204
763,2019-04-23,5399.37,5633.80,5389.41,5572.36,5572.36,15867308108,BTC,5200.466667,4886.400914627455,5514.532419372545,1.0920628565684232,97.8639356254572500000,5248.587333,0.06168758305007326,1,450795549430,5204.96,5572.36,0.0705865174756,2019-04-23,0.055762082,0.007434944,0.936803,0.2875874,269,258.8667565142878,264.65839372444054,-5.791637210152771
764,2019-04-24,5571.51,5642.04,5418.26,5464.87,5464.87,17048033399,BTC,5223.888095,4907.709730489141,5540.066459510859,0.8810853809886844,92.5727193693287500000,5265.914667,0.03778172370448706,-1,433747516031,5324.55,5464.87,0.0263534007569,2019-04-24,0.064257026,0.004016064,0.93172693,0.335008,249,254.37066859332208,262.60084869821685,-8.230180104894771
765,2019-04-25,5466.52,5542.24,5181.34,5210.52,5210.52,15330283408,BTC,5237.589048,4952.834270066089,5522.343825933911,0.45246954555705143,76.8971390316420000000,5258.312667,-0.00908897397827561,-1,418417232623,5064.49,5210.52,0.0288340978065,2019-04-25,0.059925094,0.011235955,0.92883897,0.3000037,267,227.6592530587386,255.61252957032121,-27.9532765115826
766,2019-04-26,5210.30,5383.63,5177.37,5279.35,5279.35,16812108040,BTC,5249.144762,4979.329371659193,5518.960152340806,0.5559738974894055,62.3988708475747500000,5272.636667,0.00127324020674835,1,435229340663,5089.54,5279.35,0.0372941366017,2019-04-26,0.11392405,0.016877636,0.8691983,0.2565316,237,209.62781065348008,246.41558578695302,-36.787775133472934
767,2019-04-27,5279.47,5310.75,5233.64,5268.29,5268.29,13111274675,BTC,5259.071905,5003.550912702376,5514.5928972976235,0.5180378428345785,47.3533488287722500000,5284.553333,-0.00307752272996125,-1,422118065988,5096.59,5268.29,0.0336891921854,2019-04-27,0.088785045,0.004672897,0.90654206,0.2726682,214,192.22941206641462,235.57835104284536,-43.34893897643073
768,2019-04-28,5271.75,5326.23,5255.68,5285.14,5285.14,12819992056,BTC,5263.178571,5008.950478116014,5517.406663883987,0.54319237254795,38.4327887365582500000,5297.123333,-0.00226223409323817,1,434938058044,5167.72,5285.14,0.0227218192936,2019-04-28,0.1407767,0.014563107,0.83980584,0.3186019,206,177.7516990757931,224.0130206494349,-46.261321573641794
769,2019-04-29,5284.86,5311.27,5216.49,5247.35,5247.35,13735490672,BTC,5261.158571,5007.143859907456,5515.173282092544,0.4728193478625559,40.1627906976745000000,5302.432000,-0.01038806343956886,-1,421202567372,5067.11,5247.35,0.0355705717855,2019-04-29,0.087272726,0.018181818,0.89454544,0.3260145,275,161.3685142646118,211.48411937247027,-50.11560510785847
770,2019-04-30,5247.73,5363.26,5224.19,5350.73,5350.73,13878964574,BTC,5268.100000,5012.572985146385,5523.627014853616,0.6616854484981474,39.3483516078085000000,5321.340000,0.00552304494732530,1,435081531946,5235.56,5350.73,0.0219976468611,2019-04-30,0.05862069,0.0068965517,0.93448275,0.3471759,290,154.9405658881651,200.17540867560928,-45.234842787444165
771,2019-05-01,5350.91,5418.00,5347.65,5402.70,5402.70,13679528236,BTC,5271.821429,5010.628012368898,5533.014845631101,0.7505395669770033,42.6718417893347500000,5332.482667,0.01316785020878531,1,448761060182,5251.94,5402.70,0.0287055830798,2019-05-01,0.042307694,0.01923077,0.9346154,0.2858577,260,152.2844745289749,190.59722184628242,-38.312747317307526
772,2019-05-02,5402.42,5522.26,5394.22,5505.28,5505.28,14644460907,BTC,5292.811429,5030.752502169739,5554.870355830261,0.9053831967678363,52.2489729906510000000,5349.372000,0.02914510338783693,1,463405521089,5298.39,5505.28,0.0390477107197,2019-05-02,0.048,0.016,0.932,0.35328,250,156.65107560620345,183.80799259826665,-27.156916992063202
773,2019-05-03,5505.55,5865.88,5490.20,5768.29,5768.29,18720780006,BTC,5325.132857,5006.951514294752,5643.314199705247,1.1963908367979423,68.3306157417642500000,5380.698667,0.07203364413939592,1,482126301095,5303.81,5768.29,0.0875747811479,2019-05-03,0.045045044,0.006006006,0.9429429,0.3296757,333,179.26785906435907,182.89996589148515,-3.63210682712608
774,2019-05-04,5769.20,5886.89,5645.47,5831.17,5831.17,17567780766,BTC,5360.112857,4990.15529775068,5730.07041624932,1.1366367320022068,83.6433230156975000000,5415.856000,0.07668483061588048,1,499694081861,5337.89,5831.17,0.0924110463123,2019-05-04,0.06538462,0.0038461538,0.9269231,0.3100615,260,199.9606910151715,186.31211091622245,13.648580098949054
775,2019-05-05,5831.07,5833.86,5708.04,5795.71,5795.71,14808830723,BTC,5390.017143,4985.469680956652,5794.564605043348,1.0014156496630418,93.9370135978380000000,5446.377333,0.06414037178132476,-1,484885251138,5314.53,5795.71,0.0905404617153,2019-05-05,0.067669176,0.007518797,0.91729325,0.2705526,266,211.0655514778864,191.26279902855526,19.802752449331138
776,2019-05-06,5791.69,5802.96,5653.69,5746.81,5746.81,15737171804,BTC,5422.383810,5017.5812057852445,5827.186414214756,0.9007214709368392,95.1736083138645000000,5475.196000,0.04960808708948502,-1,469148079334,5399.37,5746.81,0.0643482480363,2019-05-06,0.049861494,0.002770083,0.94182825,0.3017839,361,213.4597805984995,195.70219534254414,17.757585255955348
777,2019-05-07,5745.60,5988.18,5741.40,5829.50,5829.50,18026409033,BTC,5450.666667,5018.609291535429,5882.7240424645715,0.9384062794815825,95.1063401272860000000,5503.871333,0.05916356820472932,1,487174488367,5572.36,5829.50,0.0461456187325,2019-05-07,0.06175772,0.009501188,0.9287411,0.2808052,421,219.49936431865444,200.46162913776624,19.037735180888205
778,2019-05-08,5849.48,5989.98,5794.72,5982.46,5982.46,15320605300,BTC,5485.453333,5005.605985593211,5965.30068040679,1.017879977544883,95.1063401272860000000,5531.211333,0.08158225022207807,1,502495093667,5464.87,5982.46,0.0947122255424,2019-05-08,0.06607143,0.0125,0.91964287,0.2223893,560,233.93175197041546,207.1556537042961,26.776098266119362
779,2019-05-09,5982.32,6183.04,5982.32,6174.53,6174.53,16784645411,BTC,5527.174286,4969.581611960199,6084.766960039802,1.0804915883397979,96.5346813824217500000,5578.522000,0.10683976866990934,1,519279739078,5210.52,6174.53,0.1850122444593,2019-05-09,0.08490566,0.003773585,0.91132075,0.2837189,530,257.89511264378507,217.3035454921939,40.591567151591164
780,2019-05-10,6175.82,6434.62,6161.52,6378.85,6378.85,19419875368,BTC,5578.366667,4918.825309439057,6237.908024560944,1.106848474188393,99.9327318134215000000,5656.410667,0.12772045304538706,1,538699614446,5279.35,6378.85,0.2082642749581,2019-05-10,0.06355564,0.014056301,0.91758925,0.2256275,26465,290.02988111843206,231.84881261744158,58.18106850099048
781,2019-05-11,6379.67,7333.00,6375.70,7204.77,7204.77,28867562329,BTC,5667.265714,4708.478048965214,6626.053379034786,1.3017960295433177,100.0000000000000000000,5784.772000,0.24547173164301030,1,567567176775,5268.29,7204.77,0.3675727797824,2019-05-11,0.0802716,0.01458699,0.90019274,0.2445145,34757,377.78686632086556,261.0364233581264,116.75044296273916
782,2019-05-12,7203.51,7503.87,6815.77,6972.37,6972.37,27773333680,BTC,5746.210476,4646.722789711952,6845.6981622880485,1.0576049369591418,97.0318071747505000000,5898.377333,0.18208273332926156,-1,539793843095,5285.14,6972.37,0.3192403607095,2019-05-12,0.07354713,0.01352437,0.9067354,0.2438567,29872,423.698044284929,293.56874754348695,130.12929674144203
783,2019-05-13,6971.18,8047.41,6898.28,7814.92,7814.92,28677672181,BTC,5861.236667,4452.2813713950145,7270.191962604986,1.193309198345117,97.0318071747505000000,6067.029333,0.28809662374513527,1,568471515276,5247.35,7814.92,0.4893079363869,2019-05-13,0.058030482,0.013797457,0.9224231,0.2390855,44356,522.051838481445,339.2653657310786,182.78647275036639
784,2019-05-14,7807.88,8268.71,7696.39,7994.42,7994.42,32031452227,BTC,5976.572857,4296.486826070122,7656.658887929878,1.1005189930313215,97.0318071747505000000,6250.167333,0.27907295502163478,1,600502967503,5350.73,7994.42,0.4940802469943,2019-05-14,0.061760433,0.011452109,0.92090666,0.2662268,42001,607.4794340658227,392.90817939802747,214.57125466779524
785,2019-05-15,7989.37,8216.42,7899.11,8205.17,8205.17,28344112920,BTC,6107.063333,4185.570802914773,8028.555863085227,1.045957539295492,97.0318071747505000000,6440.463333,0.27400306092232511,1,628847080423,5402.70,8205.17,0.5187165676421,2019-05-15,0.071960166,0.011556604,0.90904087,0.2500674,38160,684.2990097052543,451.18634545947293,233.1126642457814
786,2019-05-16,8194.50,8320.82,7729.61,7884.91,7884.91,33167197581,BTC,6234.415238,4210.704395170728,8258.126080829272,0.907789177947109,97.0345088133220000000,6605.944000,0.19360836240815847,-1,595679882842,5505.28,7884.91,0.4322450447570,2019-05-16,0.102726445,0.01343258,0.87827975,0.2499761,35064,711.1392013349468,503.1769166345677,207.96228470037914
787,2019-05-17,7886.93,7929.15,7038.12,7343.90,7343.90,30066644905,BTC,6332.727143,4303.30038345293,8362.15390254707,0.7491277037328694,88.2759258555777500000,6728.518667,0.09145866474564988,-1,565613237937,5768.29,7343.90,0.2731502750382,2019-05-17,0.084018916,0.012210921,0.8989441,0.2152189,30874,680.9061981806062,538.7227729437755,142.18342523683077
788,2019-05-18,7341.66,7447.27,7251.50,7271.21,7271.21,21354286562,BTC,6428.104286,4420.640427450398,8435.568144549601,0.7099927504072593,78.7781305774247500000,6828.713333,0.06479942053821752,-1,544258951375,5831.17,7271.21,0.2469555852428,2019-05-18,0.08132169,0.014243716,0.8983479,0.2603145,24151,643.6611250747173,559.7104433699639,83.95068170475349
789,2019-05-19,7267.96,8261.94,7267.96,8197.69,8197.69,25902422040,BTC,6566.797143,4489.747693534313,8643.846592465687,0.8925984664013517,78.7020636059477500000,6986.481333,0.17336461793420496,1,570161373415,5795.71,8197.69,0.4144410262073,2019-05-19,0.06885973,0.014636851,0.9116984,0.2538629,27055,681.052579193185,583.9788705346081,97.07370865857695
790,2019-05-20,8196.92,8200.97,7678.78,7978.31,7978.31,23843404340,BTC,6696.842857,4624.7931367071415,8768.892577292858,0.8092269288834636,79.3605289705330000000,7131.988000,0.11866565114803895,-1,546317969075,5746.81,7978.31,0.3883023799290,2019-05-20,0.05701531,0.012844109,0.92559814,0.2109036,25537,685.0861961897826,604.200335665643,80.88586052413962
791,2019-05-21,7977.97,8062.17,7843.34,7963.33,7963.33,25127245056,BTC,6821.252381,4775.09071809157,8867.41404390843,0.779078051285704,85.5741456661280000000,7279.756000,0.09390067469294301,-1,521190724019,5829.50,7963.33,0.3660399691226,2019-05-21,0.06210514,0.014577175,0.9181012,0.2130201,34506,679.2442015724191,619.2091088469983,60.03509272542078
792,2019-05-22,7956.29,7997.61,7615.99,7680.07,7680.07,24719473175,BTC,6929.698571,4959.3081275468685,8900.089014453131,0.6904118626572725,89.1658623285372500000,7403.127333,0.03740887526890252,-1,496471250844,5982.46,7680.07,0.2837645383337,2019-05-22,0.07363856,0.015149201,0.9059894,0.2269148,32741,644.3302262844845,624.2333323344956,20.096893949988953
793,2019-05-23,7677.27,7943.79,7533.20,7881.85,7881.85,24457107820,BTC,7042.868571,5144.402866929624,8941.334275070376,0.7209630195586877,85.2614108427790000000,7529.753333,0.04676071730755061,1,520928358664,6174.53,7881.85,0.2765101149399,2019-05-23,0.05600201,0.011049724,0.9278629,0.2674648,31856,625.7295877963952,624.5325834268756,1.1970043695196182
794,2019-05-24,7881.70,8140.72,7824.45,7987.37,7987.37,25919126991,BTC,7148.539048,5301.709260435323,8995.368835564675,0.7271002335050394,84.5870314346820000000,7650.609333,0.04401749616823625,1,546847485655,6378.85,7987.37,0.2521645751193,2019-05-24,0.07282134,0.013548909,0.9088116,0.2460426,30925,612.4431663279902,622.1147000070986,-9.671533679108393
795,2019-05-25,7991.89,8117.93,7965.98,8052.54,8052.54,22256813107,BTC,7254.318571,5471.024855727211,9037.61228627279,0.7238053726550301,84.0368078850207500000,7762.188667,0.03740585876692141,1,569104298762,7204.77,8052.54,0.1176678783639,2019-05-25,0.0763131,0.012797362,0.90617883,0.2449256,25474,600.2529139943053,617.7423428045399,-17.489428810234585
796,2019-05-26,8055.21,8687.52,7924.67,8673.22,8673.22,26677970091,BTC,7391.342857,5636.79813419419,9145.887579805809,0.8653019288531058,89.9428865007645000000,7860.085333,0.10345112458081249,1,595782268853,6972.37,8673.22,0.2439414431535,2019-05-26,0.07470295,0.01644111,0.90275335,0.2428187,27857,633.3745919209705,620.8687926278261,12.505799293144378
797,2019-05-27,8674.07,8907.17,8668.71,8805.78,8805.78,27949839564,BTC,7537.008095,5849.246592824777,9224.769597175224,0.8758741692368205,93.9234049579997500000,7982.312667,0.10316149809620080,1,623732108417,7814.92,8805.78,0.1267908052802,2019-05-27,0.06227636,0.012216721,0.9201576,0.2451178,27667,662.6812673117074,629.2312875646024,33.449979747104976
798,2019-05-28,8802.76,8807.02,8634.72,8719.96,8719.96,24226919267,BTC,7674.649048,6104.385370296096,9244.912725703904,0.832845676443491,95.5066986650917500000,8042.648667,0.08421495965366406,-1,599505189150,7994.42,8719.96,0.0907558021720,2019-05-28,0.065939166,0.01180802,0.9169458,0.2511103,30149,671.2443746142899,637.63390497454,33.61046963974991
799,2019-05-29,8718.59,8755.85,8482.73,8659.49,8659.49,23473479966,BTC,7802.126667,6381.29686680107,9222.95646719893,0.8017121870895305,96.2186475690257500000,8086.986667,0.07079315900645345,-1,576031709184,8205.17,8659.49,0.0553699679592,2019-05-29,0.06569297,0.012160661,0.9168757,0.2428715,31495,665.4800356107353,643.203131101779,22.27690450895625
800,2019-05-30,8661.76,9008.31,8221.27,8319.47,8319.47,29246528551,BTC,7904.266667,6680.070959666678,9128.462374333321,0.6695820899031093,88.2960699088342500000,8094.606667,0.02777940204515684,-1,546785180633,7884.91,8319.47,0.0551128674899,2019-05-30,0.06331289,0.016383728,0.9155927,0.2054426,33753,626.2558949599661,639.8136838734165,-13.557788913450395
801,2019-05-31,8320.29,8586.66,8172.55,8574.50,8574.50,25365190957,BTC,8008.821429,6970.936396787169,9046.70646121283,0.7725150442693739,84.5282391810082500000,8140.579333,0.05330341358396783,1,572150371590,7343.90,8574.50,0.1675676411716,2019-05-31,0.08858809,0.01232996,0.8937211,0.2164444,29846,608.7321848209294,633.5973840629191,-24.86519924198967
802,2019-06-01,8573.84,8625.60,8481.58,8564.02,8564.02,22488303544,BTC,8073.547619,7077.576296121579,9069.518941878421,0.7462281642720916,81.9877881100242500000,8221.920667,0.04160820164235720,-1,549662068046,7271.21,8564.02,0.1777984682054,2019-06-01,0.09622433,0.013380437,0.8843895,0.2769195,22645,587.2296519789961,624.3238376461345,-37.09418566713839
803,2019-06-02,8565.47,8809.30,8561.24,8742.96,8742.96,20266216022,BTC,8157.861429,7258.302650591703,9057.420207408297,0.8252141966950108,82.9759094933340000000,8320.037333,0.05083182323263741,1,569928284068,8197.69,8742.96,0.0665150792479,2019-06-02,0.07701362,0.015554061,0.9023037,0.2677285,23788,577.965278362336,615.0521257893748,-37.08684742703883
804,2019-06-03,8741.75,8743.50,8204.19,8209.00,8209.00,22004511436,BTC,8176.627143,7290.778271416526,9062.476014583473,0.518272223422339,77.6450737522055000000,8320.791333,-0.01343518044451362,-1,547923772632,7978.31,8209.00,0.0289146448308,2019-06-03,0.06960515,0.012908591,0.91191787,0.22074,27656,521.5252673707955,596.346754105659,-74.82148673486347
805,2019-06-04,8210.99,8210.99,7564.49,7707.77,7707.77,24609731549,BTC,8162.977143,7256.737006896046,9069.217279103954,0.2488484978402108,57.0280717966582500000,8302.755333,-0.07166119066946134,-1,523314041083,7963.33,7707.77,-0.0320921021733,2019-06-04,0.07531603,0.01448249,0.9058107,0.2212294,28241,431.37841810539067,563.3530869056053,-131.97466880021466
806,2019-06-05,7704.34,7901.85,7668.67,7824.23,7824.23,21760923463,BTC,8144.837143,7226.968409527879,9062.70587647212,0.32535239990842424,39.1681694219647500000,8293.482000,-0.05658081852712769,1,545074964546,7680.07,7824.23,0.0187706622466,2019-06-05,0.0746246,0.015814483,0.90275615,0.2121872,26305,365.12480779083944,523.7074310826522,-158.58262329181275
807,2019-06-06,7819.63,7937.34,7571.47,7822.02,7822.02,19474611077,BTC,8141.842381,7220.009911732298,9063.674850267702,0.32652901060533024,18.1645858381810000000,8302.945333,-0.05792225694761177,1,564549575623,7881.85,7822.02,-0.0075908574764,2019-06-06,0.07481257,0.015393205,0.9051683,0.2304731,25076,308.8794457746999,480.7418340210617,-171.86238824636183
808,2019-06-07,7826.90,8126.15,7788.37,8043.95,8043.95,19141423231,BTC,8175.178095,7326.837395148366,9023.518794851634,0.42265601837625444,14.0723011128902500000,8313.752000,-0.03245249557600467,1,583690998854,7987.37,8043.95,0.0070836833651,2019-06-07,0.09303135,0.01406872,0.88845515,0.2089053,25873,278.9963906820012,440.39274535324967,-161.39635467124845
809,2019-06-08,8036.77,8076.89,7837.61,7954.13,7954.13,16522722810,BTC,8207.698095,7458.31099877752,8957.08519122248,0.33081634559883055,19.0663723277887500000,8311.536000,-0.04300119737194184,-1,567168276044,8052.54,7954.13,-0.0122209886570,2019-06-08,0.108024225,0.0145166945,0.87205285,0.2449773,19977,245.23916642781296,401.3620295681623,-156.12286314034935
810,2019-06-09,7949.67,7975.97,7583.22,7688.08,7688.08,16610726547,BTC,8183.430952,7400.431446996203,8966.430457003797,0.1836837387288018,15.8648372965640000000,8287.238667,-0.07229895156584127,-1,550557549497,8673.22,7688.08,-0.1135841129361,2019-06-09,0.11734073,0.014892685,0.86299706,0.2709518,20547,194.77308854857347,360.04424136424456,-165.2711528156711
811,2019-06-10,7692.28,8031.91,7586.73,8000.33,8000.33,18689275117,BTC,8184.479524,7402.575516043111,8966.38353195689,0.3822428826773877,20.2477490476630000000,8242.379333,-0.02936643937641980,1,569246824614,8805.78,8000.33,-0.0914683310280,2019-06-10,0.09131243,0.013732782,0.8906025,0.2510227,23666,177.92333421528292,323.62005993445223,-145.6967257191693
812,2019-06-11,8004.24,8026.39,7772.80,7927.71,7927.71,17107279932,BTC,8182.783333,7398.712871055838,8966.853794944163,0.3373402995136898,18.2725291551625000000,8183.841333,-0.03129720171469996,-1,552139544682,8719.96,7927.71,-0.0908547745632,2019-06-11,0.076283425,0.013129678,0.90542257,0.2476974,22849,156.9012949602502,290.27630693961186,-133.37501197936166
813,2019-06-12,7925.43,8196.65,7862.36,8145.86,8145.86,19034432883,BTC,8204.963810,7455.0113262391615,8954.916293760838,0.4605949634944816,23.5123919432185000000,8145.568000,0.00003584771497826,1,571173977565,8659.49,8145.86,-0.0593141166512,2019-06-12,0.0734065,0.013296749,0.9083157,0.2426652,23690,156.04526654151869,263.4300988599932,-107.38483231847454
814,2019-06-13,8145.55,8311.57,8087.06,8230.92,8230.92,18669407147,BTC,8221.586190,7486.383843037582,8956.788536962418,0.5063477830549399,36.3773623663945000000,8116.996667,0.01403515828251602,1,589843384712,8319.47,8230.92,-0.0106437068708,2019-06-13,0.06897533,0.01268138,0.91338456,0.2526035,24603,160.38170847508718,242.820420783012,-82.43871230792482
815,2019-06-14,8230.90,8710.64,8183.39,8693.83,8693.83,19831162906,BTC,8255.227143,7500.640705349737,9009.813580650263,0.790624662143268,53.2288032762017500000,8141.954000,0.06778176344400865,1,609674547618,8574.50,8693.83,0.0139168464634,2019-06-14,0.069484696,0.014943351,0.9101517,0.2180411,26567,198.8787873862875,234.0320941036671,-35.15330671737959
816,2019-06-15,8689.75,8859.13,8618.40,8838.38,8838.38,18371033226,BTC,8292.648095,7503.144231155902,9082.151958844099,0.8456169944139521,72.5497212953130000000,8159.546000,0.08319506992178241,1,628045580844,8564.02,8838.38,0.0320363567577,2019-06-15,0.07720311,0.015849056,0.9009101,0.2379936,22525,238.3049456513445,234.8866644132026,3.418281238141901
817,2019-06-16,8841.44,9335.87,8814.56,8994.49,8994.49,23348550311,BTC,8307.946667,7476.151756259779,9139.74157774022,0.9126878658039876,86.7006199757317500000,8188.244000,0.09846384646085290,1,651394131155,8742.96,8994.49,0.0287694327779,2019-06-16,0.071484245,0.014809041,0.9071744,0.2443897,26943,278.9318793843504,243.6957074074322,35.2361719769182
818,2019-06-17,8988.92,9416.41,8988.92,9320.35,9320.35,15562951919,BTC,8332.450000,7413.327846094438,9251.572153905563,1.0374149648129927,98.8356495525557500000,8226.736667,0.13293403900805811,1,666957083074,8209.00,9320.35,0.1353818979169,2019-06-17,0.06655296,0.012894423,0.91495824,0.2592527,29315,333.5779171593904,261.67214935782386,71.90576780156653
819,2019-06-18,9335.47,9348.37,9004.90,9081.76,9081.76,15848210536,BTC,8349.678571,7387.493989138791,9311.86315286121,0.8804267095944796,96.3457332426620000000,8284.920667,0.09617947654875233,-1,651108872538,7707.77,9081.76,0.1782603788125,2019-06-18,0.066028886,0.013351094,0.9157155,0.2351478,33031,353.5574861608111,280.0492167184213,73.5082694423898
820,2019-06-19,9078.73,9299.62,9070.40,9273.52,9273.52,15546809946,BTC,8378.918095,7342.719101859803,9415.1170881402,0.9316747607951782,95.6284805822565000000,8389.304000,0.10539801633127134,1,666655682484,7824.23,9273.52,0.1852310067572,2019-06-19,0.072364055,0.013411099,0.9091258,0.2539311,28633,380.4789435133698,300.135162077411,80.34378143595882
821,2019-06-20,9273.06,9594.42,9232.48,9527.16,9527.16,17846823784,BTC,8436.427143,7286.29549305478,9586.558792945221,0.9741773939757025,95.6284805822565000000,8502.832667,0.12046895112677865,1,684502506268,7822.02,9527.16,0.2179922833232,2019-06-20,0.07462056,0.012935097,0.9080568,0.248357,30769,417.4687013421426,323.60186993035734,93.86683141178526
822,2019-06-21,9525.07,10144.56,9525.07,10144.56,10144.56,20624008643,BTC,8511.191905,7140.405076735019,9881.97873326498,1.0957775714358782,95.6284805822565000000,8657.668667,0.17174269311870398,1,705126514911,8043.95,10144.56,0.2611416033168,2019-06-21,0.070705995,0.015481115,0.9074336,0.2368855,37465,490.9430848109296,357.0701129064718,133.87297190445776
823,2019-06-22,10175.92,11157.35,10107.04,10701.69,10701.69,29995204861,BTC,8612.985714,6941.2696993902055,10284.701728609794,1.1247186327540022,99.2827473395945000000,8834.851333,0.21130391408251216,1,735121719772,7954.13,10701.69,0.3454255839419,2019-06-22,0.07564426,0.016043456,0.9011622,0.2305887,39580,587.3571107786593,403.1275124809094,184.22959829774987
824,2019-06-23,10696.69,11246.14,10556.10,10855.37,10855.37,20998326502,BTC,8713.576667,6775.945288039249,10651.20804596075,1.0526833835001046,100.0000000000000000000,9028.267333,0.20237578259580320,1,756120046274,7688.08,10855.37,0.4119741209769,2019-06-23,0.091220066,0.014689114,0.888792,0.2400314,29818,668.4610102031911,456.19421202536574,212.26679817782536
825,2019-06-24,10853.74,11065.90,10610.43,11011.10,11011.10,19271652365,BTC,8847.010000,6682.65332352544,11011.366676474561,0.9999383935934729,100.0000000000000000000,9249.802000,0.19041467049781174,1,775391698639,8000.33,11011.10,0.3763307263575,2019-06-24,0.08705331,0.010981835,0.8966817,0.2598989,33692,736.8090680406076,512.3171832284141,224.49188481219346
826,2019-06-25,11007.20,11790.92,11007.20,11790.92,11790.92,24879684533,BTC,9041.445714,6592.077336694769,11490.81409130523,1.0612618974498527,100.0000000000000000000,9502.508000,0.24082189670348081,1,800271383172,7927.71,11790.92,0.4873046567041,2019-06-25,0.065909535,0.012534341,0.9162333,0.2387367,40768,844.1692949156131,578.6876055658539,265.4816893497592
827,2019-06-26,11778.58,13796.49,11755.60,13016.23,13016.23,45105733173,BTC,9288.683810,6355.062734567959,12222.304885432042,1.1353148709655752,100.0000000000000000000,9841.742667,0.32255337701972857,1,845377116345,8145.86,13016.23,0.5978951270952,2019-06-26,0.06586995,0.016938996,0.9109513,0.2018816,56733,1016.4087969411521,666.2318438409136,350.1769531002385
828,2019-06-27,13017.13,13311.14,10491.85,11182.81,11182.81,39977475223,BTC,9448.721429,6484.622188533947,12412.820669466051,0.7925152686060783,90.4216236774630000000,10044.206000,0.11335928394937340,-1,805399641122,8230.92,11182.81,0.3586342717461,2019-06-27,0.0632075,0.015182432,0.91626585,0.2189109,41166,993.5155430074155,731.6885836742141,261.82695933320144
829,2019-06-28,11162.17,12445.17,10914.50,12407.33,12407.33,35087757766,BTC,9656.501429,6500.466563772518,12812.53629422748,0.9358045282243302,86.8998533646737500000,10322.633333,0.20195395881548164,1,840487398888,8693.83,12407.33,0.4271420076077,2019-06-28,0.077389374,0.014308573,0.9021478,0.23272,32498,1061.9396256176515,797.7387920629017,264.2008335547498
830,2019-06-29,12400.76,12400.91,11508.38,11959.37,11959.37,29923961128,BTC,9847.227143,6639.610792211504,13054.843493788496,0.8292386972152692,80.5756674795892500000,10540.336000,0.13462891505545933,-1,810563437760,8838.38,11959.37,0.3531178790683,2019-06-29,0.10344828,0.013196645,0.87858343,0.2476453,26825,1067.7116604192015,851.7333657341618,215.9782946850397
831,2019-06-30,11931.99,12178.38,10799.01,10817.16,10817.16,27256473494,BTC,9996.230952,6921.9303228558365,13070.531581144163,0.6335147643365856,66.9057758406470000000,10672.254667,0.01357776191830075,-1,783306964266,8994.49,10817.16,0.2026429514069,2019-06-30,0.10310724,0.0145130735,0.87783253,0.2509603,26390,968.9497884213397,875.1766502715974,93.7731381497423
832,2019-07-01,10796.93,11206.44,10089.31,10583.13,10583.13,29378589324,BTC,10119.221429,7176.440707632633,13062.002150367365,0.578821464275538,61.0240012406962500000,10778.164000,-0.01809528969869080,-1,753928374942,9320.35,10583.13,0.1354863283031,2019-07-01,0.088515446,0.011737918,0.89435875,0.2573007,31181,861.8610307202052,872.513526361319,-10.652495641113774
833,2019-07-02,10588.68,10912.19,9737.88,10801.68,10801.68,31015895223,BTC,10256.077143,7478.686280581514,13033.468005418486,0.5982221955833941,50.4743083068475000000,10876.919333,-0.00691733851254443,1,784944270165,9081.76,10801.68,0.1893817938373,2019-07-02,0.08426343,0.012709636,0.89770937,0.2349105,34226,785.5719922851858,855.1252195460925,-69.55322726090662
834,2019-07-03,10818.16,11968.08,10818.16,11961.27,11961.27,30796494294,BTC,10437.763333,7742.1758647375955,13133.350801262406,0.7825926973132248,49.7517286129797500000,11068.886667,0.08062087541834617,1,815740764459,9273.52,11961.27,0.2898306144808,2019-07-03,0.098808125,0.016087199,0.88007164,0.2294786,32386,809.3518967331293,845.9705549834997,-36.61865825037046
835,2019-07-04,11972.72,12006.08,11166.57,11215.44,11215.44,25920294033,BTC,10579.883333,8064.275155526143,13095.491510473857,0.6263226667593,50.5185400614987500000,11198.348000,0.00152629655731363,-1,789820470426,9527.16,11215.44,0.1772070585568,2019-07-04,0.08988108,0.014401595,0.88939303,0.2407931,29094,759.2630823064974,828.6290604480993,-69.36597814160189
836,2019-07-05,11203.10,11395.66,10874.96,10978.46,10978.46,23838480210,BTC,10688.675238,8322.474086511656,13054.876389488343,0.5612341773685903,48.2384039732922500000,11295.101333,-0.02803350971937668,-1,765981990216,10144.56,10978.46,0.0822016923356,2019-07-05,0.09360683,0.01301541,0.8887963,0.2536839,28812,692.4627509772963,801.3957985539388,-108.93304757664248
837,2019-07-06,10982.54,11620.96,10982.54,11208.55,11208.55,21092024306,BTC,10801.540476,8584.618874089134,13018.462077910866,0.5917961022277872,43.7360313726572500000,11366.034000,-0.01385566856477818,1,787074014522,10701.69,11208.55,0.0473626128210,2019-07-06,0.09710551,0.018292164,0.87908494,0.2649614,23562,650.5897534860142,771.2345895403539,-120.64483605433975
838,2019-07-07,11217.62,11541.62,11148.80,11450.85,11450.85,19369044277,BTC,10918.510000,8847.637762521308,12989.382237478692,0.628530382117665,34.6985833968850000000,11415.978000,0.00305466601284621,1,806443058799,10855.37,11450.85,0.0548557994799,2019-07-07,0.10096255,0.013366399,0.88062716,0.2560952,23791,629.6979206539763,742.9272557630785,-113.22933510910218
839,2019-07-08,11446.60,12345.83,11393.37,12285.96,12285.96,23482551458,BTC,11059.729524,9042.822922062505,13076.636125937495,0.8039879176413148,40.0981701016315000000,11511.350667,0.06729091619288432,1,829925610257,11011.10,12285.96,0.1157795315636,2019-07-08,0.09368178,0.013667858,0.8863859,0.2278219,31607,672.7720924162932,728.8962230937215,-56.1241306774283
840,2019-07-09,12284.33,12779.13,12233.26,12573.81,12573.81,28167921523,BTC,11226.017619,9321.341735129941,13130.69350287006,0.853811478481435,53.2926102502980000000,11615.531333,0.08249977030990460,1,858093531780,11790.92,12573.81,0.0663977026390,2019-07-09,0.0818229,0.013081884,0.8997157,0.2410906,32717,721.8151376156402,727.4800059981053,-5.664868382465102
841,2019-07-10,12571.54,13129.53,11710.98,12156.51,12156.51,33627574244,BTC,11363.302857,9643.02797995107,13083.577734048931,0.7305466276298581,63.0328593152767500000,11639.904000,0.04438232480267878,-1,824465957536,13016.23,12156.51,-0.0660498469987,2019-07-10,0.08677856,0.013323078,0.8954756,0.2291315,36403,718.7244734542674,725.7288994893378,-7.0044260350704235
842,2019-07-11,12139.71,12144.62,11158.92,11358.66,11358.66,28595327690,BTC,11450.517143,9949.477752242477,12951.55653375752,0.46940215441193645,63.8565839918290000000,11529.399333,-0.01480903974861047,-1,795870629846,11182.81,11358.66,0.0157250279670,2019-07-11,0.06891836,0.020853275,0.90453076,0.1732533,43878,644.466266792746,709.4763729500195,-65.01010615727353
843,2019-07-12,11354.30,11905.49,11179.14,11815.99,11815.99,23534692797,BTC,11530.109048,10147.314029497189,12912.904066502811,0.6033706905849033,61.8429777929757500000,11571.611333,0.02111881050680291,1,819405322643,12407.33,11815.99,-0.0476605361508,2019-07-12,0.08788121,0.014291597,0.8932975,0.2037077,41283,615.4245804705533,690.6660144541263,-75.24143398357296
844,2019-07-13,11813.13,11841.96,10908.48,11392.38,11392.38,21042616384,BTC,11562.999048,10231.03923674585,12894.95885925415,0.4359518783681061,51.5518091628100000000,11503.948000,-0.00969823577088492,-1,798362706259,11959.37,11392.38,-0.0474096879685,2019-07-13,0.093492046,0.015269069,0.88659793,0.2150272,28227,551.8654862811345,662.905908819528,-111.0404225383935
845,2019-07-14,11381.02,11451.20,10234.58,10256.06,10256.06,22486000001,BTC,11534.460476,10115.951960135873,12952.968991864127,0.04938568866425702,35.3853959451042500000,11390.394000,-0.09958689752084081,-1,775876706258,10817.16,10256.06,-0.0518712859937,2019-07-14,0.09243198,0.016332097,0.8864447,0.1908367,28594,405.1328001067377,611.35128707697,-206.21848697023233
846,2019-07-15,10257.84,11052.77,9992.01,10895.09,10895.09,25384047207,BTC,11528.936190,10100.995043222918,12956.877336777083,0.27805591237754607,32.5386687732280000000,11395.589333,-0.04392044310956568,1,801260753465,10583.13,10895.09,0.0294771017648,2019-07-15,0.06710372,0.014027654,0.91440266,0.1917844,34931,336.5311479745833,556.3872592564927,-219.85611128190942
847,2019-07-16,10896.65,10996.63,9448.11,9477.64,9477.64,24151199070,BTC,11418.780000,9740.719332109831,13096.84066789017,-0.0783879084778866,17.0557684577580000000,11321.890000,-0.16289241460568863,-1,777109554395,10801.68,9477.64,-0.1225772287274,2019-07-16,0.067370266,0.015816875,0.91140854,0.198241,35342,165.87536755224573,478.2848809156433,-312.4095133633976
848,2019-07-17,9471.21,9963.13,9163.13,9693.80,9693.80,24569921549,BTC,11260.569048,9588.594005783105,12932.544090216894,0.03146159229667697,8.6381661479575000000,11248.031333,-0.13817807641059138,1,801679475944,11961.27,9693.80,-0.1895676629656,2019-07-17,0.07100914,0.0131190745,0.91048664,0.1969188,34911,47.52391146577247,392.13268702566916,-344.6087755598967
849,2019-07-18,9698.50,10736.84,9376.80,10666.48,10666.48,25187024648,BTC,11235.981905,9544.136583670426,12927.827226329575,0.33169208856739774,18.2374452573087500000,11161.712000,-0.04436882084038721,1,826866500592,11215.44,10666.48,-0.0489468090418,2019-07-18,0.072804675,0.013516873,0.90879995,0.1963424,32182,31.849535198982267,320.0760566603318,-288.22652146134953
850,2019-07-19,10653.96,10716.98,10229.63,10530.73,10530.73,20727426310,BTC,11146.620000,9517.550922581857,12775.689077418145,0.3109687279264719,19.8478281231327500000,11116.064667,-0.05265664464310551,-1,806139074282,10978.46,10530.73,-0.0407825869931,2019-07-19,0.08765548,0.013719987,0.89328897,0.2223405,28863,8.377023477718467,257.73625002380913,-249.35922654609067
851,2019-07-20,10525.82,11048.66,10451.28,10767.14,10767.14,20206615155,BTC,11089.847143,9497.045429073965,12682.648856926036,0.3986982685357071,30.2598856005967500000,11101.976667,-0.03016009464290113,1,826345689437,11208.55,10767.14,-0.0393815435538,2019-07-20,0.113707975,0.014996211,0.8657919,0.2449488,25073,8.75033169065864,207.93906635717903,-199.1887346665204
852,2019-07-21,10777.53,10841.89,10389.60,10599.11,10599.11,17130580467,BTC,11079.463810,9476.386327212893,12682.541292787106,0.3501776067726755,37.5698039836312500000,11061.347333,-0.04178851988681151,-1,809215108970,11450.85,10599.11,-0.0743822510993,2019-07-21,0.089020416,0.014494504,0.8928212,0.2671561,24837,-4.461011808496551,165.45905072404392,-169.92006253254047
853,2019-07-22,10596.95,10651.79,10154.92,10343.11,10343.11,16334414913,BTC,11068.034286,9446.774686360615,12689.293885639385,0.27643176757095417,34.9587554946917500000,10987.498000,-0.05864738268894338,-1,792880694057,12285.96,10343.11,-0.1581357907726,2019-07-22,0.13051355,0.012352999,0.8515993,0.2428901,30357,-35.18259418751222,125.33072174173269,-160.51331592924492
854,2019-07-23,10346.75,10346.75,9883.59,9900.77,9900.77,17851916995,BTC,11025.133810,9328.3530176585,12721.914602341498,0.16867735211440718,29.8721484931382500000,10828.485333,-0.08567360110585099,-1,775028777062,12573.81,9900.77,-0.2125879109037,2019-07-23,0.07635783,0.012886049,0.9075967,0.2197286,28170,-94.1376505336084,81.43704728666447,-175.57469782027286
855,2019-07-24,9887.73,9908.80,9614.31,9811.93,9811.93,17398734322,BTC,10922.784286,9204.014151449464,12641.554420550536,0.17684617516044634,22.5797832739772500000,10644.360000,-0.07820385631451774,-1,757630042740,12156.51,9811.93,-0.1928662091340,2019-07-24,0.077680334,0.013934625,0.9043294,0.215613,28849,-146.34166732290032,35.8813043647515,-182.2229716876518
856,2019-07-25,9809.10,10154.25,9773.96,9911.84,9911.84,15821952090,BTC,10860.708095,9092.868037929009,12628.54815207099,0.23163067235502283,18.1666449013315000000,10494.715333,-0.05553988979264484,1,773451994830,11358.66,9911.84,-0.1273759404719,2019-07-25,0.076099664,0.013517463,0.9058892,0.2405882,27372,-177.60451047892275,-6.815858603983363,-170.78865187493938
857,2019-07-26,9913.13,9916.52,9717.98,9870.30,9870.30,14495714483,BTC,10807.938571,8989.430504179445,12626.446637820556,0.2421956525495786,15.3764599113857500000,10395.491333,-0.05052106881497796,-1,758956280347,11815.99,9870.30,-0.1646658468736,2019-07-26,0.11727308,0.018582769,0.85943943,0.2973791,55051,-203.38794018259796,-46.130274919706295,-157.25766526289166
858,2019-07-27,9871.17,10167.32,9411.52,9477.68,9477.68,16817809536,BTC,10725.516190,8828.081402235464,12622.950977764536,0.17117810897992994,11.9604223612832500000,10239.604000,-0.07440951818058589,-1,742138470811,11392.38,9477.68,-0.1680684808618,2019-07-27,0.06738648,0.014855655,0.91458,0.2585268,26118,-252.5909356463617,-87.42240706503739,-165.1685285813243
859,2019-07-28,9491.63,9575.54,9252.30,9552.86,9552.86,13738687093,BTC,10635.135714,8702.326047482666,12567.945380517334,0.22002527389307916,10.1674082926870000000,10116.969333,-0.05575872718719844,1,755877157904,10256.06,9552.86,-0.0685643414723,2019-07-28,0.062191628,0.015000796,0.9199029,0.2695677,25132,-282.2644969282683,-126.39082503768358,-155.8736718905847
860,2019-07-29,9548.18,9681.65,9472.95,9519.15,9519.15,13791445323,BTC,10503.382857,8668.475000761515,12338.290713238486,0.23180319282689946,6.2573706742250000000,10067.842000,-0.05449946473136944,-1,742085712581,10895.09,9519.15,-0.1262899159163,2019-07-29,0.067779854,0.013365557,0.91479,0.2500395,27309,-304.98544098755883,-162.10974822765866,-142.87569275990018
861,2019-07-30,9522.33,9701.76,9437.34,9607.42,9607.42,13829811132,BTC,10362.126190,8753.928893117853,11970.32348688215,0.2653564673118254,4.5754165520955000000,9981.997333,-0.03752528882788472,1,755915523713,9477.64,9607.42,0.0136932822939,2019-07-30,0.06649226,0.012317419,0.9177022,0.2572221,27522,-312.2696513931296,-192.14172886075286,-120.12792253237674
862,2019-07-31,9604.05,10085.63,9598.10,10085.63,10085.63,16631520648,BTC,10263.512857,8879.033659884451,11647.992054115548,0.435758205189863,16.3618050878457500000,10022.530000,0.00629581552761628,1,772547044361,9693.80,10085.63,0.0404206812602,2019-07-31,0.079712786,0.015490596,0.9009331,0.2240882,27436,-276.2702190739237,-208.96742690338704,-67.30279217053669
863,2019-08-01,10077.44,10446.92,9922.02,10399.67,10399.67,17165337858,BTC,10217.846667,8924.84153790989,11510.85179609011,0.5703103680369581,32.9106329239172500000,10069.588000,0.03278008991033198,1,789712382219,10666.48,10399.67,-0.0250138752428,2019-08-01,0.06656292,0.012980123,0.9162128,0.2197875,28274,-219.8655331363807,-211.1470481499858,-8.718484986394884
864,2019-08-02,10402.04,10657.95,10371.01,10518.17,10518.17,17489094082,BTC,10156.045714,9077.598979301038,11234.492448698962,0.6678915955460163,52.3514877207045000000,10059.700667,0.04557484841511935,1,807201476301,10530.73,10518.17,-0.0011926998413,2019-08-02,0.078925274,0.014529259,0.9027489,0.247001,27393,-163.71524605555533,-201.66068773109973,37.9454416755444
865,2019-08-03,10519.28,10946.78,10503.50,10821.73,10821.73,15352685061,BTC,10128.871905,9157.857675884503,11099.886134115497,0.8567703099629799,74.8353962123680000000,10079.100667,0.07368011864703802,1,822554161362,10767.14,10821.73,0.0050700557437,2019-08-03,0.093226224,0.015805472,0.88684326,0.2592794,23030,-93.64154254715322,-180.05685869431045,86.41531614715723
866,2019-08-04,10821.63,11009.21,10620.28,10970.18,10970.18,16530894787,BTC,10162.877619,9125.411329949515,11200.343908050487,0.8890740304144542,88.0484854124982500000,10092.636667,0.08694886796720946,1,839085056149,10599.11,10970.18,0.0350095432541,2019-08-04,0.08134013,0.021565808,0.89369583,0.2527153,22953,-25.83118746168475,-149.21172444778531,123.38053698610057
867,2019-08-05,10960.74,11895.09,10960.74,11805.65,11805.65,23875988832,BTC,10206.237619,8981.103687727098,11431.371550272901,1.1527500137630777,95.1729793867200000000,10173.072667,0.16048025866323048,1,862961044981,10343.11,11805.65,0.1414023441692,2019-08-05,0.06720622,0.014373584,0.91489154,0.2144618,30890,94.23813561053794,-100.52175243612065,194.7598880466586
868,2019-08-06,11811.54,12273.82,11290.73,11478.17,11478.17,23635107660,BTC,10301.500952,9005.26439312805,11597.73751087195,0.9538789775471217,96.4832021031200000000,10248.743333,0.11995877221760062,-1,839325937321,9900.77,11478.17,0.1593209417045,2019-08-06,0.06397693,0.015633706,0.91671854,0.2057029,30511,161.11184302483707,-48.1950333439291,209.30687636876615
869,2019-08-07,11476.19,12036.99,11433.70,11941.97,11941.97,22194988641,BTC,10408.556667,8960.640586126066,11856.472747873935,1.0295242428948161,96.4832021031200000000,10384.823333,0.14994445423561834,1,861520925962,9811.93,11941.97,0.2170867505170,2019-08-07,0.07879919,0.014460401,0.90307534,0.2162277,30013,248.66803153433284,11.177579631723306,237.49045190260952
870,2019-08-08,11954.04,11979.42,11556.17,11966.41,11966.41,19481591730,BTC,10470.458095,8872.82109464455,12068.09509535545,0.9681764082414134,96.4832021031200000000,10528.455333,0.13657793299392440,1,881002517692,9911.84,11966.41,0.2072844194418,2019-08-08,0.06745687,0.014910724,0.91400856,0.2200083,26491,316.3819908334044,72.21846187205955,244.16352896134487
871,2019-08-09,11953.47,11970.46,11709.75,11862.94,11862.94,18339989960,BTC,10533.896667,8824.330664889132,12243.46266911087,0.8887078157143325,95.4438165530602500000,10658.528667,0.11299977423047072,-1,862662527732,9870.30,11862.94,0.2018824149215,2019-08-09,0.06447572,0.013963599,0.9181711,0.2005137,27142,357.5747282804441,129.2897151537365,228.2850131267076
872,2019-08-10,11861.56,11915.66,11323.90,11354.02,11354.02,18125355447,BTC,10561.843333,8817.430648600655,12306.256017399346,0.7270611404298434,92.8089828948900000000,10757.443333,0.05545710523707018,-1,844537172285,9477.68,11354.02,0.1979746098201,2019-08-10,0.11995824,0.018446188,0.85316527,0.2644005,25859,345.1757080092593,172.46691372484108,172.70879428441825
873,2019-08-11,11349.74,11523.58,11248.29,11523.58,11523.58,15774371518,BTC,10605.865714,8811.556414658648,12400.175013341352,0.755729122715039,88.2852502306042500000,10893.836667,0.05780730446488527,1,860311543803,9552.86,11523.58,0.2062963342915,2019-08-11,0.10261154,0.015058297,0.87703824,0.2713743,23243,345.05390343201543,206.98431166627594,138.0695917657395
874,2019-08-12,11528.19,11528.19,11320.95,11382.62,11382.62,13647198229,BTC,10655.366190,8834.345612219768,12476.386767780234,0.6996830290864972,82.3215397952602500000,11015.820667,0.03329750402517151,-1,846664345574,9519.15,11382.62,0.1957601256415,2019-08-12,0.16878536,0.013777038,0.81198,0.2539543,30050,329.78156191500784,231.54376171602235,98.2378001989855
875,2019-08-13,11385.05,11420.05,10830.33,10895.83,10895.83,16681503537,BTC,10702.750000,8912.675285190588,12492.824714809412,0.5539307098197175,72.0151799203712500000,11107.599333,-0.01906526573846126,-1,829982842037,9607.42,10895.83,0.1341057224520,2019-08-13,0.07342582,0.013980736,0.9081009,0.2093399,27824,275.2256070294334,240.28013077870455,34.94547625072883
876,2019-08-14,10889.49,10889.56,10028.14,10051.70,10051.70,19990838300,BTC,10714.167619,8945.020612638971,12483.314625361028,0.3127720261182157,53.1668114754215000000,11137.218000,-0.09746760815851858,-1,809992003737,10085.63,10051.70,-0.0033641924203,2019-08-14,0.061706785,0.016755236,0.9174742,0.1789708,31990,162.00785767999696,224.62567615896305,-62.617818478966086
877,2019-08-15,10038.42,10437.41,9675.32,10311.55,10311.55,22899115082,BTC,10733.201429,8991.927815494235,12474.475042505766,0.378924418962774,36.0833555837380000000,11152.279333,-0.07538632309112374,1,832891118819,10399.67,10311.55,-0.0084733457889,2019-08-15,0.0774707,0.015950838,0.90298533,0.1983083,29779,92.187024341496,198.13794579546965,-105.95092145397365
878,2019-08-16,10319.42,10524.35,9855.48,10374.34,10374.34,20228207096,BTC,10757.203333,9052.371745137627,12462.034920862372,0.3877122714859894,21.2597144097000000000,11150.590667,-0.06961520606233908,1,853119325915,10518.17,10374.34,-0.0136744319592,2019-08-16,0.07144206,0.016312351,0.9085451,0.2199868,26483,41.44241674760997,166.79883998589773,-125.35642323828776
879,2019-08-17,10358.72,10452.63,10086.70,10231.74,10231.74,13778035685,BTC,10793.110952,9171.746775155025,12414.475128844977,0.32688313951391945,9.9562074674495000000,11131.495333,-0.08082969143710820,-1,839341290230,10821.73,10231.74,-0.0545190094375,2019-08-17,0.123963155,0.014754788,0.8516494,0.2789999,26161,-10.162531273212153,131.40656573407574,-141.5690970072879
880,2019-08-18,10233.01,10487.07,10119.09,10345.81,10345.81,12999813869,BTC,10830.870476,9296.202872087333,12365.538079912667,0.34196562344727655,13.7963451384285000000,11099.767333,-0.06792550784001195,1,852341104099,10970.18,10345.81,-0.0569152010268,2019-08-18,0.08287097,0.015668694,0.8960895,0.2303595,22529,-41.3783448932536,96.84958360860986,-138.22792850186346
881,2019-08-19,10350.28,10916.05,10313.20,10916.05,10916.05,16038264603,BTC,10897.389524,9485.316738447127,12309.462309552873,0.5066074766792892,21.6891853074357500000,11096.158667,-0.01623162324955244,1,868379368702,11805.65,10916.05,-0.0753537501112,2019-08-19,0.07277241,0.015438924,0.9082199,0.2213142,25779,-19.874400066866656,73.50478687351456,-93.37918694038122
882,2019-08-20,10916.35,10947.04,10618.96,10763.23,10763.23,15053082175,BTC,10952.428095,9667.117935332395,12237.738254667604,0.42639982903078877,26.7668471987925000000,11026.664000,-0.02389063455638079,-1,853326286527,11478.17,10763.23,-0.0622869324988,2019-08-20,0.07631011,0.016041478,0.9041687,0.2163367,28738,-14.990860387310022,55.80565742134964,-70.79651780865967
883,2019-08-21,10764.57,10798.73,9962.72,10138.05,10138.05,19473084768,BTC,10954.924286,9676.499245059838,12233.34932694016,0.1805153764043662,25.5435548986530000000,10937.322667,-0.07307754295405026,-1,833853201759,11941.97,10138.05,-0.1510571538867,2019-08-21,0.07494572,0.017090425,0.9045318,0.2118373,28554,-60.86579812683158,32.471366311713396,-93.33716443854497
884,2019-08-22,10142.52,10233.00,9831.46,10131.06,10131.06,17097508856,BTC,10942.133333,9635.31565724973,12248.95100875027,0.18967616980909477,22.7396054755027500000,10816.595333,-0.06337810668653957,-1,816755692903,11966.41,10131.06,-0.1533751559574,2019-08-22,0.06904035,0.016846286,0.9100673,0.2077159,27187,-96.6716804227326,6.642756964824186,-103.3144373875568
885,2019-08-23,10136.31,10442.44,10078.19,10407.96,10407.96,15627023886,BTC,10936.885238,9622.055968647983,12251.714507352019,0.29886162776834524,16.3713033026272500000,10712.698667,-0.02844648920619173,1,832382716789,11862.94,10407.96,-0.1226491915158,2019-08-23,0.080374956,0.014155027,0.90072656,0.2076877,26563,-101.5341616468977,-14.992626757520199,-86.5415348893775
886,2019-08-24,10407.64,10418.02,9982.30,10159.96,10159.96,15451030650,BTC,10905.372381,9547.920512904413,12262.824249095585,0.22543690184545415,8.9197978145215000000,10599.166667,-0.04143784891763699,-1,816931686139,11354.02,10159.96,-0.1051662759093,2019-08-24,0.08865624,0.008878876,0.8979592,0.2288029,22638,-123.97018925390148,-36.78813925679646,-87.18204999710503
887,2019-08-25,10160.74,10304.62,10008.79,10138.52,10138.52,14153856610,BTC,10865.769524,9468.321542463997,12263.217505536002,0.23979370480730033,9.2669871539802500000,10518.133333,-0.03609132162348488,-1,802777829529,11523.58,10138.52,-0.1201935509625,2019-08-25,0.07784024,0.01586726,0.9012603,0.2452599,22058,-141.84582126218993,-57.79967565787517,-84.04614560431476
888,2019-08-26,10126.30,10512.33,10126.30,10370.82,10370.82,18438654080,BTC,10797.444286,9453.727877994628,12141.160694005372,0.34125211113806136,14.2251486792407500000,10441.282667,-0.00674846848296708,1,821216483609,11382.62,10370.82,-0.0888899040818,2019-08-26,0.07399451,0.017464295,0.90416515,0.217332,25137,-135.703415328373,-73.38042359197475,-62.322991736398265
889,2019-08-27,10372.83,10381.33,10087.30,10185.50,10185.50,14762609503,BTC,10735.888571,9404.769792584104,12067.007349415895,0.2932609095730014,13.1777593246917500000,10361.474667,-0.01698355423870864,-1,806453874106,10895.83,10185.50,-0.0651928306517,2019-08-27,0.086036615,0.015068118,0.89385957,0.200525,25617,-144.12787318275332,-87.52991351013047,-56.59795967262285
890,2019-08-28,10203.43,10279.37,9716.66,9754.42,9754.42,17603790323,BTC,10631.719524,9355.776017766653,11907.663030233347,0.15621537328488982,11.3389545308227500000,10285.380667,-0.05162285035337137,-1,788850083783,10051.70,9754.42,-0.0295750967498,2019-08-28,0.06787857,0.02043265,0.90692604,0.20715,27505,-183.4738971634506,-106.7187102407945,-76.75518692265611
891,2019-08-29,9756.79,9756.79,9421.63,9510.20,9510.20,17045878501,BTC,10514.757143,9304.031545613989,11725.482740386013,0.08514251901138252,9.8643098587027500000,10249.280667,-0.07211049155670468,-1,771804205282,10311.55,9510.20,-0.0777138257585,2019-08-29,0.07110954,0.024094969,0.90060335,0.1944342,25524,-231.69162082737603,-131.7132923581108,-99.97832846926522
892,2019-08-30,9514.84,9656.12,9428.30,9598.17,9598.17,13595263986,BTC,10406.910952,9301.689660295848,11512.132243704153,0.13412713903068504,5.4343161691217500000,10201.722000,-0.05916177680591571,1,785399469268,10374.34,9598.17,-0.0748163256651,2019-08-30,0.078510985,0.023207111,0.89434993,0.2158418,23398,-259.81112944352935,-157.33285977519452,-102.47826966833483
893,2019-08-31,9597.54,9673.22,9531.80,9630.66,9630.66,11454806419,BTC,10324.846190,9259.792822032437,11389.899557967563,0.17410732134263224,3.7064765088737500000,10152.143333,-0.05136682135927838,1,796854275687,10231.74,9630.66,-0.0587466061491,2019-08-31,0.08753041,0.03090222,0.8769605,0.2195834,19319,-276.28947802378025,-181.12418342491168,-95.16529459886857
894,2019-09-01,9630.59,9796.76,9582.94,9757.97,9757.97,11445355859,BTC,10240.769524,9301.873081478758,11179.665966521241,0.2428898959806863,8.1125297862505000000,10120.558667,-0.03582694186461159,1,808299631546,10345.81,9757.97,-0.0568191374093,2019-09-01,0.07954158,0.02633504,0.8872958,0.2035169,20505,-275.8954835721379,-200.07844345435694,-75.81704011778095
895,2019-09-02,9757.47,10396.59,9730.65,10346.76,10346.76,17248102294,BTC,10191.442857,9408.633991563669,10974.251722436331,0.5992050229997253,22.9889390760040000000,10120.622000,0.02234427883977882,1,825547733840,10916.05,10346.76,-0.0521516482610,2019-09-02,0.0712517,0.028077323,0.896038,0.1978682,25038,-225.47368753655428,-205.15749227079644,-20.31619526575784
896,2019-09-03,10345.73,10736.10,10308.55,10623.54,10623.54,19384917989,BTC,10178.476667,9436.726745683298,10920.226588316704,0.8000090193538238,43.6375387876482500000,10101.121333,0.05171887850641661,1,844932651829,10763.23,10623.54,-0.0129784460613,2019-09-03,0.07013675,0.02205558,0.9034333,0.2046191,27204,-161.32061443133534,-196.39011670290424,35.06950227156889
897,2019-09-04,10621.18,10762.64,10434.71,10594.49,10594.49,16742664769,BTC,10204.323810,9443.543956363583,10965.103663636417,0.7564251590884421,65.8431019090877500000,10089.872000,0.05001232919505817,-1,828189987060,10138.05,10594.49,0.0450224648724,2019-09-04,0.059567362,0.021115,0.91669315,0.2106402,25148,-111.53720257475288,-179.41953387727398,67.8823313025211
898,2019-09-05,10588.18,10627.27,10516.42,10575.53,10575.53,14551239508,BTC,10216.894286,9440.117850451872,10993.67072154813,0.7308487343252955,85.3589862248990000000,10119.037333,0.04511226236030332,-1,813638747552,10131.06,10575.53,0.0438720133925,2019-09-05,0.06195428,0.023658562,0.9099308,0.2056364,27601,-72.77450436717481,-158.09052797525416,85.31602360807935
899,2019-09-06,10578.20,10898.76,10292.30,10353.30,10353.30,19536574783,BTC,10215.892381,9439.915005043593,10991.869756956406,0.5885384182951482,89.4143497987810000000,10133.853333,0.02165480985257516,-1,794102172769,10407.96,10353.30,-0.0052517496224,2019-09-06,0.07871112,0.031315178,0.88072425,0.1777368,33083,-59.303279226000086,-138.33307822540334,79.02979899940325
900,2019-09-07,10353.93,10558.67,10348.92,10517.25,10517.25,15307366476,BTC,10229.488095,9442.41910245566,11016.55708754434,0.6828060231859459,89.8146567984620000000,10141.139333,0.03708761458154004,1,809409539245,10159.96,10517.25,0.0351664770334,2019-09-07,0.07954493,0.025977615,0.8892267,0.2260262,21711,-34.99444722962653,-117.66535202624797,82.67090479662144
901,2019-09-08,10518.11,10595.64,10409.09,10441.28,10441.28,13670567493,BTC,10234.034286,9443.050215905756,11025.018356094244,0.631004985963439,86.3743330878257500000,10159.894000,0.02769576139278618,-1,795738971752,10138.52,10441.28,0.0298623467725,2019-09-08,0.078074455,0.02660422,0.892376,0.2283833,20711,-21.610553816748507,-98.45439238434808,76.84383856759958
902,2019-09-09,10443.23,10450.31,10144.93,10334.97,10334.97,17595943368,BTC,10206.363810,9477.358622186464,10935.368997813537,0.5882066356658722,80.9725690265327500000,10172.990667,0.01592248909904559,-1,778143028384,10370.82,10334.97,-0.0034568144081,2019-09-09,0.06925016,0.020128498,0.906555,0.2477233,24592,-19.35889312213476,-82.63529253190542,63.27639940977066
903,2019-09-10,10336.41,10394.35,10020.57,10115.98,10115.98,14906809639,BTC,10175.542381,9492.115292192282,10858.969469807716,0.45642374879820014,75.6435590206047500000,10156.001333,-0.00394065850207781,-1,763236218745,10185.50,10115.98,-0.0068253890334,2019-09-10,0.070063695,0.023161551,0.9031461,0.2329197,25905,-34.84344507795504,-73.07692304111535,38.23347796316031
904,2019-09-11,10123.04,10215.95,9980.78,10178.37,10178.37,15428063426,BTC,10177.462381,9494.251164613595,10860.673597386403,0.5006642301664791,68.0340237483610000000,10155.526000,0.00224941573681166,1,778664282171,9754.42,10178.37,0.0434623483508,2019-09-11,0.07053136,0.024873978,0.9013305,0.2294648,24202,-41.60116019914858,-66.781770472722,25.18061027357342
905,2019-09-12,10176.82,10442.25,10099.24,10410.13,10410.13,15323563925,BTC,10190.751429,9500.510848266422,10880.992009733578,0.6589145706029388,67.3345518889110000000,10199.240000,0.02067703083759182,1,793987846096,9510.20,10410.13,0.0946278732308,2019-09-12,0.064012095,0.021401985,0.9100884,0.2107407,25792,-27.933601844537407,-59.01213674708508,31.078534902547673
906,2019-09-13,10415.36,10441.49,10226.60,10360.55,10360.55,14109864675,BTC,10188.493810,9500.93213944306,10876.055480556939,0.6251205509031869,67.4023027160277500000,10255.930000,0.01020092765843761,-1,779877981421,9598.17,10360.55,0.0794297246246,2019-09-13,0.06398929,0.022534583,0.9091477,0.2434815,22410,-20.862168924604703,-51.38214318258901,30.51997425798431
907,2019-09-14,10345.40,10422.13,10291.69,10358.05,10358.05,13468713124,BTC,10197.926667,9506.584230451126,10889.269103548873,0.6158060929973592,72.1146937540580000000,10306.588667,0.00499305198477268,1,793346694545,9630.66,10358.05,0.0755285722889,2019-09-14,0.07519577,0.024892392,0.8950889,0.2397636,19283,-15.283557161983481,-44.16242597846791,28.878868816484427
908,2019-09-15,10356.47,10387.04,10313.09,10347.71,10347.71,12043433567,BTC,10207.888095,9514.116679255043,10901.659510744958,0.6007694334378573,74.1442506567602500000,10354.392000,-0.00064533002034306,-1,781303260978,9757.97,10347.71,0.0604367506766,2019-09-15,0.0885616,0.024320528,0.881498,0.2596331,20641,-11.563521653810312,-37.64264511353639,26.079123459726077
909,2019-09-16,10347.22,10386.87,10189.74,10276.79,10276.79,15160167779,BTC,10203.410476,9512.84932405251,10893.971627947489,0.5531303591239242,61.8571011149062500000,10388.980000,-0.01079894272584989,-1,766143093199,10346.76,10276.79,-0.0067625034310,2019-09-16,0.06711511,0.02386653,0.9040398,0.2338781,26313,-14.174621792377366,-32.94904044930458,18.774418656927217
910,2019-09-17,10281.51,10296.77,10199.74,10241.27,10241.27,15304603363,BTC,10206.066190,9515.365390507885,10896.766989492115,0.5254841242589315,49.4403683391555000000,10381.947333,-0.01355018750218890,-1,750838489836,10623.54,10241.27,-0.0359832974696,2019-09-17,0.06571396,0.020561742,0.9085553,0.2475389,26311,-18.892325641199932,-30.137697487683653,11.245371846483721
911,2019-09-18,10247.80,10275.93,10191.47,10198.25,10198.25,16169268880,BTC,10227.200952,9568.10542900186,10886.296474998138,0.47803736257507473,35.4234527247495000000,10353.594667,-0.01500393554087354,-1,734669220956,10594.49,10198.25,-0.0374005733169,2019-09-18,0.059538845,0.021939162,0.914661,0.2253401,27713,-25.80503007385596,-29.271164004918113,3.466133931062153
912,2019-09-19,10200.50,10295.67,9851.69,10266.42,10266.42,19937691247,BTC,10263.211429,9691.853315754526,10834.569542245476,0.5028078458375025,26.5742614340457500000,10331.723333,-0.00632066218724791,1,754606912203,10575.53,10266.42,-0.0292287951526,2019-09-19,0.0685772,0.019716414,0.90774065,0.241686,26729,-25.488829500307475,-28.51469710399599,3.025867603688514
913,2019-09-20,10266.32,10285.87,10132.19,10181.64,10181.64,14734189639,BTC,10290.995714,9805.112401482624,10776.879026517377,0.3874671025092159,22.7442848303670000000,10305.464000,-0.01201537359210609,-1,739872722564,10353.30,10181.64,-0.0165802207992,2019-09-20,0.067792185,0.02371421,0.90509963,0.2505751,22982,-31.713699939833532,-29.1544976711635,-2.559202268670031
914,2019-09-21,10183.65,10188.10,10000.71,10019.72,10019.72,13425266806,BTC,10309.522381,9906.843292995432,10712.201469004569,0.14015715040469942,16.5730932471060000000,10283.225333,-0.02562477476345699,-1,726447455758,10517.25,10019.72,-0.0473060923721,2019-09-21,0.075507775,0.028115148,0.89208746,0.2468108,19349,-49.14602065524559,-33.15280226797992,-15.99321838726567
915,2019-09-22,10024.12,10074.44,9922.53,10070.39,10070.39,13199651698,BTC,10324.399524,9990.010950841393,10658.788097158607,0.12018809195444705,15.2797652988230000000,10253.434667,-0.01785203426410051,1,739647107456,10441.28,10070.39,-0.0355215069417,2019-09-22,0.07654464,0.023682052,0.89514303,0.2371236,20733,-58.20170189204873,-38.162582192793685,-20.039119699255046
916,2019-09-23,10067.96,10074.24,9727.14,9729.32,9729.32,15144925408,BTC,10294.997619,9872.021419674093,10717.973818325907,-0.16868729245465194,7.0956721642347500000,10205.970667,-0.04670311943392145,-1,724502182048,10334.97,9729.32,-0.0586020085206,2019-09-23,0.06253503,0.019337017,0.91372406,0.2307116,24978,-91.84120483379229,-48.89830672099341,-42.94289811279888
917,2019-09-24,9729.32,9804.32,8370.80,8620.57,8620.57,25002886689,BTC,10199.618095,9375.08552966085,11024.15066033915,-0.45754137639821396,3.0049103330487500000,10091.677333,-0.14577431327391411,-1,699499295359,10115.98,8620.57,-0.1478265081584,2019-09-24,0.06256077,0.02494531,0.90790594,0.1795576,32912,-205.59761078719384,-80.23816753423351,-125.35944325296033
918,2019-09-25,8603.43,8744.83,8325.40,8486.99,8486.99,21744728353,BTC,10099.260952,9007.021211889713,11191.500692110289,-0.2380572656316291,3.0049103330487500000,9983.078000,-0.14986239714845461,-1,677754567006,10178.37,8486.99,-0.1661739551618,2019-09-25,0.07936508,0.021299688,0.8939764,0.1867445,29484,-303.03596176735664,-124.79772638085815,-178.2382353864985
919,2019-09-26,8487.67,8515.69,7895.63,8118.97,8118.97,19258205289,BTC,9982.281905,8613.173271580152,11351.390538419848,-0.18048358600504133,0E-19,9845.784667,-0.17538619067993070,-1,658496361717,10410.13,8118.97,-0.2200894705446,2019-09-26,0.07528474,0.02284989,0.8980218,0.1928024,28359,-405.2808696661468,-180.89435503791591,-224.3865146282309
920,2019-09-27,8113.10,8271.52,7965.92,8251.85,8251.85,16408941156,BTC,9882.212857,8331.810180246082,11432.615533753918,-0.025786907312845605,1.4819903817842500000,9701.899333,-0.14946035649615619,1,674905302873,10360.55,8251.85,-0.2035316657899,2019-09-27,0.065388,0.019141687,0.9106849,0.1969973,26121,-470.168579619145,-238.74919995416175,-231.41937966498327
921,2019-09-28,8251.27,8285.62,8125.43,8245.92,8245.92,14141152736,BTC,9774.054286,8097.912249422296,11450.196322577705,0.044151315147462705,2.8994252210932500000,9560.924000,-0.13753942610567765,-1,660764150137,10358.05,8245.92,-0.2039119332307,2019-09-28,0.09553096,0.022468224,0.87474376,0.2726441,24390,-516.1215309541822,-294.22366615416587,-221.8978648000163
922,2019-09-29,8246.04,8261.71,7990.50,8104.19,8104.19,13034629109,BTC,9662.764286,7866.6338638583165,11458.894708141683,0.06612997954191549,2.8994252210932500000,9410.666667,-0.13882934262047218,-1,647729521028,10347.71,8104.19,-0.2168131886185,2019-09-29,0.08883603,0.023320751,0.8824655,0.2331792,19339,-557.54892552204,-346.8887180277407,-210.6602074942993
923,2019-09-30,8104.23,8314.23,7830.76,8293.87,8293.87,17115474183,BTC,9565.569048,7702.558135021714,11428.579960978284,0.15869790693630217,5.0820635346347500000,9273.744000,-0.10566110084557003,1,664844995211,10276.79,8293.87,-0.1929513009412,2019-09-30,0.0642956,0.019492146,0.91271263,0.2239001,24574,-568.5212839382002,-391.21523120983267,-177.30605272836755
924,2019-10-01,8299.72,8497.69,8232.68,8343.28,8343.28,15305343413,BTC,9481.154762,7563.059592071053,11399.249931928947,0.20338417513398194,6.3644645450705000000,9144.843333,-0.08765194807739196,1,680150338624,10241.27,8343.28,-0.1853276009714,2019-10-01,0.06678746,0.020436542,0.9085623,0.2171189,23732,-566.6974475527077,-426.3116744784078,-140.3857730742999
925,2019-10-02,8344.21,8393.04,8227.70,8393.04,8393.04,13125712443,BTC,9396.139048,7449.780964492191,11342.497131507807,0.2423138484897468,8.2867530469417500000,9021.628000,-0.06967567272780478,1,693276051067,10198.25,8393.04,-0.1770117422107,2019-10-02,0.062027514,0.02380617,0.91097337,0.2141048,21297,-554.840966651791,-452.0175329130845,-102.82343373870646
926,2019-10-03,8390.77,8414.23,8146.44,8259.99,8259.99,13668823409,BTC,9293.751429,7345.210526793573,11242.292331206427,0.23473448059791246,10.0881340286135000000,8892.410667,-0.07111914762854260,-1,679607227658,10266.42,8259.99,-0.1954361890513,2019-10-03,0.06259465,0.020822817,0.91317517,0.217875,23772,-549.8424022234176,-471.58250677515116,-78.25989544826643
927,2019-10-04,8259.49,8260.06,8151.24,8205.94,8205.94,13139456229,BTC,9191.150952,7251.65262831003,11130.64927568997,0.24601397176626635,9.1299535840940000000,8755.045333,-0.06271873098478221,-1,666467771429,10181.64,8205.94,-0.1940453600795,2019-10-04,0.07304908,0.023260945,0.9004679,0.2222005,22656,-543.9718186715763,-486.06036915443616,-57.91144951714017
928,2019-10-05,8210.15,8215.53,8071.12,8151.50,8151.50,12200497197,BTC,9086.077143,7173.192471148161,10998.96181485184,0.2557152407689984,6.9671032355115000000,8619.702667,-0.05431772824281805,-1,654267274232,10019.72,8151.50,-0.1864543120965,2019-10-05,0.08411025,0.0250304,0.88756585,0.2400236,19736,-537.5160416019407,-496.3515036439371,-41.16453795800362
929,2019-10-06,8149.88,8161.41,7958.85,7988.16,7988.16,13160830305,BTC,8973.717619,7095.195566375598,10852.2396716244,0.23767738908810793,3.6273798943312500000,8484.265333,-0.05847357591120730,-1,641106443927,10070.39,7988.16,-0.2067675631232,2019-10-06,0.077163965,0.023927191,0.8951412,0.2192542,20437,-539.3625291786975,-504.9537087508892,-34.40882042780834
930,2019-10-07,7989.12,8308.45,7905.77,8245.62,8245.62,18009742607,BTC,8876.995238,7072.562117858175,10681.428358141824,0.32504886688447227,5.5226723947060000000,8362.614000,-0.01399012318397094,1,659116186534,9729.32,8245.62,-0.1524978107411,2019-10-07,0.07437947,0.023291398,0.8984614,0.2218447,23528,-514.1245062923535,-506.7878682591821,-7.336638033171425
931,2019-10-08,8246.85,8332.71,8185.76,8228.78,8228.78,15592264032,BTC,8781.162381,7069.67360641917,10492.65115558083,0.33862518141981784,13.8102399522270000000,8262.578000,-0.00409049088553234,-1,643523922502,8620.57,8228.78,-0.0454482708220,2019-10-08,0.07137203,0.023087071,0.9021988,0.2402121,22740,-489.835519628783,-503.3973985331024,13.561878904319371
932,2019-10-09,8229.84,8627.71,8169.30,8595.74,8595.74,19384942333,BTC,8704.852381,7120.559117189228,10289.145644810773,0.46556433600634395,38.2086989085895000000,8260.922667,0.04053025872491199,1,662908864835,8486.99,8595.74,0.0128137301917,2019-10-09,0.06836731,0.020108031,0.9081339,0.2326283,25363,-435.950353215685,-489.90798946961894,53.95763625393391
933,2019-10-10,8585.28,8625.27,8471.93,8586.47,8586.47,17618660671,BTC,8624.854762,7211.273870227351,10038.43565377265,0.4864228633029036,62.8272676567380000000,8267.554667,0.03857432407105244,1,680527525506,8118.97,8586.47,0.0575811956443,2019-10-10,0.063498564,0.02494879,0.9075379,0.2230412,24410,-389.5040222286061,-469.8271960214164,80.32317379281028
934,2019-10-11,8585.26,8721.78,8316.18,8321.76,8321.76,19604381101,BTC,8536.289048,7311.983592292076,9760.594503707925,0.4123874491452159,72.8571816199662500000,8281.074000,0.00491313083302963,-1,660923144405,8251.85,8321.76,0.0084720396032,2019-10-11,0.07991795,0.020964103,0.89493334,0.2123817,24375,-369.79212162928525,-449.82018114299024,80.02805951370499
935,2019-10-12,8315.67,8415.24,8313.34,8336.56,8336.56,14532641605,BTC,8456.138571,7436.429056397224,9475.848085602776,0.4413663551788169,77.6807169426250000000,8286.721333,0.00601428055768314,1,675455786010,8245.92,8336.56,0.0109921027611,2019-10-12,0.08026876,0.023849823,0.8905473,0.2636442,19497,-348.9535428505678,-429.6468534845058,80.69331063393798
936,2019-10-13,8336.90,8470.99,8276.61,8321.01,8321.01,13808286059,BTC,8372.834762,7670.587012452335,9075.082511547665,0.4631007988039963,66.3764442542547500000,8291.727333,0.00353155209089652,-1,661647499951,8104.19,8321.01,0.0267540617878,2019-10-13,0.077341706,0.02360021,0.89602304,0.2615552,19110,-329.890798304843,-409.69564244857327,79.80484414373029
937,2019-10-14,8320.83,8390.21,8284.13,8374.69,8374.69,15151387859,BTC,8308.328571,7980.203982266654,8636.453159733346,0.6011223042688973,57.6623654498172500000,8309.760667,0.00781362250995381,1,676798887810,8293.87,8374.69,0.0097445462733,2019-10-14,0.06743464,0.01958754,0.90913796,0.2554954,23178,-306.91399504759465,-389.13931296837757,82.22531792078291
938,2019-10-15,8373.46,8410.71,8182.71,8205.37,8205.37,15220412632,BTC,8288.557143,7990.823910313903,8586.290375686098,0.3602991976248339,52.8732841765692500000,8303.860667,-0.01186082846878770,-1,661578475178,8343.28,8205.37,-0.0165294704241,2019-10-15,0.06428252,0.022172552,0.9093876,0.2458555,22370,-298.92163927570436,-371.09577822984295,72.17413895413858
939,2019-10-16,8204.67,8216.81,7985.09,8047.53,8047.53,16071646996,BTC,8267.630476,7966.716055908427,8568.544896091573,0.1342806105253779,40.9806116067020000000,8284.144000,-0.02856227511255237,-1,645506828182,8393.04,8047.53,-0.0411662520374,2019-10-16,0.087740846,0.022453366,0.88500804,0.2095028,26054,-301.8445327390291,-357.2455291316802,55.40099639265111
940,2019-10-17,8047.81,8134.83,8000.94,8103.91,8103.91,14313052244,BTC,8266.913333,7964.443136760217,8569.383529239783,0.230546455441878,32.0476315876097500000,8264.868667,-0.01947504231285325,1,659819880426,8259.99,8103.91,-0.0188959066536,2019-10-17,0.0767782,0.021318372,0.89769584,0.2003785,24955,-296.19717539275734,-345.0358583838957,48.83868299113834
941,2019-10-18,8100.93,8138.41,7902.16,7973.21,7973.21,15651592610,BTC,8253.644762,7925.078577701065,8582.210946298936,0.073244637760933,16.1431416438987500000,8245.750000,-0.03305217839493072,-1,644168287816,8205.94,7973.21,-0.0283611627675,2019-10-18,0.07345056,0.020700835,0.9009436,0.1942806,24057,-298.82335211128884,-335.79335712937433,36.97000501808549
942,2019-10-19,7973.80,8082.63,7944.78,7988.56,7988.56,13797825640,BTC,8241.389524,7893.01187308214,8589.76717491786,0.13713297432559599,7.8220716275592500000,8231.258000,-0.02948492198883816,1,657966113456,8151.50,7988.56,-0.0199889590873,2019-10-19,0.083474874,0.016485164,0.89474475,0.2277129,20018,-296.2510022228289,-327.8848861480653,31.633883925236375
943,2019-10-20,7997.81,8281.82,7949.44,8222.08,8222.08,15504249442,BTC,8247.003333,7904.155764927347,8589.850901072654,0.4636524576503353,15.3734809118007500000,8235.963333,-0.00168569631003237,1,673470362898,7988.16,8222.08,0.0292833393422,2019-10-20,0.08160589,0.015685681,0.8983709,0.2536138,19827,-272.23117251280746,-316.75414342101374,44.522970908206275
944,2019-10-21,8225.12,8296.69,8196.42,8243.72,8243.72,15868748866,BTC,8244.615238,7902.440777373902,8586.789698626098,0.49869183983170035,21.4740655068830000000,8253.000667,-0.00112452032593541,1,689339111764,8245.62,8243.72,-0.0002304253652,2019-10-21,0.07216819,0.022278005,0.90053344,0.2186313,22309,-248.58360026121954,-303.1200347890549,54.536434527835354
945,2019-10-22,8243.40,8296.65,8074.46,8078.20,8078.20,16803377857,BTC,8231.992381,7885.573548722957,8578.411213277044,0.2780253746756364,25.6903281769552500000,8241.839333,-0.01985471038543478,-1,672535733907,8228.78,8078.20,-0.0182991889442,2019-10-22,0.06983757,0.020907044,0.9061595,0.2244836,24872,-240.42731316654317,-290.5814904645526,50.154177298009415
946,2019-10-23,8076.23,8093.00,7469.32,7514.67,7514.67,21942878958,BTC,8190.165238,7731.492066357311,8648.838409642687,-0.23635791208453122,25.0738920212680000000,8194.232000,-0.08293175004076038,-1,650592854949,8595.74,7514.67,-0.1257681130420,2019-10-23,0.06955602,0.023868557,0.9020463,0.1609644,30249,-276.25110745799066,-287.7154138632402,11.464306405249545
947,2019-10-24,7509.73,7532.87,7446.99,7493.49,7493.49,16268708849,BTC,8153.665238,7605.138295740314,8702.192180259686,-0.10177102265968281,15.0795945576920000000,8120.748667,-0.07724148261711004,-1,634324146100,8586.47,7493.49,-0.1272909589156,2019-10-24,0.09017561,0.020371655,0.8853638,0.2206283,27391,-302.85959463837844,-290.74425001826785,-12.11534462011059
948,2019-10-25,7490.70,8691.54,7479.98,8660.70,8660.70,28705065488,BTC,8175.320476,7583.896314353683,8766.744637646316,0.9103480678307729,29.2162626700722500000,8125.697333,0.06584083126346001,1,663029211588,8321.76,8660.70,0.0407293649420,2019-10-25,0.077097036,0.025411373,0.8912429,0.1990919,33607,-227.14453935647543,-278.02430788590937,50.87976852943393
949,2019-10-26,8667.58,10021.74,8662.62,9244.97,9244.97,44496255609,BTC,8227.390476,7474.3222983832275,8980.458653616774,1.1756224431234912,50.0000000000000000000,8187.244667,0.12919185587103940,1,707525467197,8336.56,9244.97,0.1089670079745,2019-10-26,0.081871346,0.02073715,0.89223605,0.2384864,25992,-118.62665229109552,-246.1447767669466,127.51812447585107
950,2019-10-27,9241.71,9749.53,9112.54,9551.71,9551.71,32593129501,BTC,8301.845238,7362.0861584350505,9241.60431756495,1.1649921182877045,75.0000000000000000000,8268.254667,0.15522687491986512,1,740118596698,8321.01,9551.71,0.1479027185402,2019-10-27,0.08280458,0.020632675,0.891222,0.2528777,21907,-7.7843572707424755,-198.47269286770577,190.6883355969633
951,2019-10-28,9565.10,9805.12,9256.15,9256.15,9256.15,30948255332,BTC,8349.965714,7322.868371532961,9377.06305646704,0.941138462992898,96.4100047613957500000,8330.597333,0.11110279731485853,-1,709170341366,8374.69,9256.15,0.1052528511503,2019-10-28,0.076855086,0.01976618,0.898397,0.2230891,24891,55.56917138931749,-147.66432001630113,203.23349140561862
952,2019-10-29,9248.44,9516.18,9232.65,9427.69,9427.69,28426779937,BTC,8407.056667,7279.847591498329,9534.265742501671,0.9527258319605709,94.9036060285100000000,8400.797333,0.12223752416525533,1,737597121303,8205.37,9427.69,0.1489658601623,2019-10-29,0.07647301,0.018788628,0.89967036,0.2526409,24270,118.25596254589436,-94.48026350386202,212.7362260497564
953,2019-10-30,9422.46,9426.87,9085.37,9205.73,9205.73,27706531577,BTC,8436.103810,7258.176755730912,9614.030864269089,0.8266866938876607,90.7011884055152500000,8467.488000,0.08718547932987918,-1,709890589726,8047.53,9205.73,0.1439199356821,2019-10-30,0.06550661,0.023018118,0.906576,0.2339321,23677,148.315688237848,-45.921073155520006,194.236761393368
954,2019-10-31,9202.46,9383.16,9028.72,9199.58,9199.58,26583653947,BTC,8465.299524,7242.193114590317,9688.405933409682,0.800170316479002,86.4240703131830000000,8544.291333,0.07669315586994627,-1,683306935779,8103.91,9199.58,0.1352026367519,2019-10-31,0.0945812,0.019027233,0.881278,0.2522976,25227,169.6859498114536,-2.7996685621252717,172.4856183735789
955,2019-11-01,9193.99,9275.66,9132.05,9261.10,9261.10,24324691031,BTC,8510.030000,7241.123059267152,9778.93694073285,0.7959515689803949,86.4841950811865000000,8621.437333,0.07419443444210673,1,707631626810,7973.21,9261.10,0.1615271640907,2019-11-01,0.08146841,0.02014116,0.8934412,0.2258184,23236,189.4028675706977,35.640838664439336,153.76202890625837
956,2019-11-02,9259.78,9377.49,9249.59,9324.72,9324.72,21242676385,BTC,8557.085238,7242.721972207487,9871.448503792511,0.7920177328362661,85.2334784425375000000,8711.538000,0.07038734147747505,1,728874303195,7988.56,9324.72,0.1672591806283,2019-11-02,0.090039544,0.02297745,0.88051724,0.24399,18714,207.76725763767718,70.06612245908691,137.70113517859028
957,2019-11-03,9324.79,9379.81,9141.25,9235.35,9235.35,21132220847,BTC,8600.625238,7258.816370990708,9942.434105009293,0.7365183215008535,85.5932553371357500000,8794.657333,0.05010913447945249,-1,707742082348,8222.08,9235.35,0.1232376722192,2019-11-03,0.07883312,0.022924608,0.8926302,0.206034,18888,212.65836372847116,98.58457071296377,114.07379301550739
958,2019-11-04,9235.61,9505.05,9191.49,9412.61,9412.61,26170255634,BTC,8650.050000,7267.354896168357,10032.745103831641,0.7757513199717134,88.1808067164830000000,8874.026000,0.06069218188001703,1,733912337982,8243.72,9412.61,0.1417915698253,2019-11-04,0.07056642,0.021256438,0.90438724,0.2124727,24275,228.20736862891135,124.5091302961533,103.69823833275805
959,2019-11-05,9413.00,9457.42,9256.93,9342.53,9342.53,26198609048,BTC,8704.200476,7305.669872595467,10102.731079404533,0.7282143567134226,89.1698895161837500000,8947.280000,0.04417543655725539,-1,707713728934,8078.20,9342.53,0.1565113515387,2019-11-05,0.07179151,0.022209473,0.9016555,0.248578,24404,232.1985563015769,146.04701549723805,86.15154080433885
960,2019-11-06,9340.86,9423.24,9305.91,9360.88,9360.88,23133895765,BTC,8766.740952,7374.095010521626,10159.386893478375,0.713313028927254,89.6091039830532500000,9032.792000,0.03632188142935208,1,730847624699,7514.67,9360.88,0.2456807817243,2019-11-06,0.08197153,0.020119486,0.8931207,0.2438638,22764,234.143235460484,163.66625948988724,70.47697597059675
961,2019-11-07,9352.39,9368.48,9202.35,9267.56,9267.56,22700383839,BTC,8822.152857,7447.794215623696,10196.511498376303,0.6620418170303649,90.0003400996977500000,9149.651333,0.01288668417065680,-1,708147240860,7493.49,9267.56,0.2367481640731,2019-11-07,0.07458803,0.019124024,0.90130097,0.2386092,23060,225.55421502417994,176.04385059674578,49.510364427434155
962,2019-11-08,9265.37,9272.76,8775.53,8804.88,8804.88,24333037836,BTC,8861.756190,7543.350649333909,10180.16173066609,0.4784299336411825,70.7353159551165000000,9237.077333,-0.04678940290517540,-1,683814203024,8660.70,8804.88,0.0166476150888,2019-11-08,0.074216254,0.020857325,0.9001066,0.2090064,23445,179.34556123477887,176.70419272435242,2.641368510426446
963,2019-11-09,8809.47,8891.82,8793.16,8813.58,8813.58,17578630606,BTC,8901.042857,7644.18941122133,10157.89630277867,0.46520562628293793,48.5673345621062500000,9247.269333,-0.04689917827442606,1,701392833630,9244.97,8813.58,-0.0466621308668,2019-11-09,0.07851368,0.024927447,0.892102,0.2354012,19296,141.79239303812756,169.72183278710747,-27.929439748979917
964,2019-11-10,8812.49,9103.83,8806.16,9055.53,9055.53,20587919881,BTC,8940.730952,7721.8625756950805,10159.59932830492,0.5470924712757015,34.2756991599815000000,9234.640000,-0.01939545017456013,1,721980753511,9551.71,9055.53,-0.0519467194879,2019-11-10,0.07433474,0.024966609,0.89551014,0.2505092,19466,130.0553821371832,161.78854265712263,-31.733160519939446
965,2019-11-11,9056.92,9081.28,8700.61,8757.79,8757.79,20265510765,BTC,8965.210476,7785.103741056484,10145.317210943516,0.41211791702471423,12.7271037717335000000,9181.712000,-0.04617025670158245,-1,701715242746,9256.15,8757.79,-0.0538409597943,2019-11-11,0.0733055,0.018827766,0.90299606,0.2416513,24432,95.6262666776147,148.55608746122104,-52.929820783606345
966,2019-11-12,8759.75,8853.77,8685.43,8815.66,8815.66,20309769107,BTC,9000.327619,7889.207481374824,10111.447756625175,0.4169002465409841,10.8413453234332500000,9152.346000,-0.03678685224531503,1,722025011853,9427.69,8815.66,-0.0649183416086,2019-11-12,0.06918103,0.018534483,0.9076724,0.2371379,23200,72.17854070014437,133.28057810900572,-61.10203740886135
967,2019-11-13,8812.03,8836.84,8761.65,8808.26,8808.26,17545755405,BTC,9061.927143,8176.154408893946,9947.699877106055,0.35681025547935374,12.4769797854682500000,9111.050667,-0.03323334246144633,-1,704479256448,9205.73,8808.26,-0.0431763695003,2019-11-13,0.069605775,0.021706956,0.9047854,0.2238956,22297,52.39495435654135,117.10345335851284,-64.70849900197149
968,2019-11-14,8811.94,8826.94,8692.55,8708.09,8708.09,19084739975,BTC,9119.765238,8568.780268236975,9670.750207763025,0.12641881304216115,4.0865160922582500000,9077.874667,-0.04073471826442435,-1,685394516473,9199.58,8708.09,-0.0534252650664,2019-11-14,0.07924952,0.02184042,0.89321077,0.2285483,24038,28.30713081831709,99.34418885047369,-71.0370580321566
969,2019-11-15,8705.71,8730.87,8484.84,8491.99,8491.99,21796856471,BTC,9111.731429,8528.648646325508,9694.814211674491,-0.031435198752878334,4.0865160922582500000,9030.702000,-0.05965339128674604,-1,663597660002,9261.10,8491.99,-0.0830473701828,2019-11-15,0.07374045,0.021945512,0.8996335,0.2149554,22647,-8.126430424659702,77.85006499544701,-85.97649542010672
970,2019-11-16,8491.17,8592.00,8473.97,8550.76,8550.76,16495389808,BTC,9078.673810,8450.356190591594,9706.991429408406,0.0798989287479648,3.5228007460425000000,8983.346000,-0.04815421781594519,1,680093049810,9324.72,8550.76,-0.0830008836726,2019-11-16,0.07981272,0.019925958,0.8976481,0.2368451,18368,-31.89042934238023,55.901966127881565,-87.7923954702618
971,2019-11-17,8549.47,8727.79,8500.97,8577.98,8577.98,18668638897,BTC,9032.305714,8406.894456935612,9657.716971064388,0.13677843269678622,3.9310464686842500000,8933.563333,-0.03980307966100138,1,698761688707,9235.35,8577.98,-0.0711797603772,2019-11-17,0.08311675,0.016655175,0.89651513,0.2196502,18853,-47.97412730535325,35.1267474412346,-83.10087474658785
972,2019-11-18,8573.98,8653.28,8273.57,8309.29,8309.29,21579470673,BTC,8987.217143,8296.471300243264,9677.962985756736,0.009278883029956716,3.9310464686842500000,8871.826000,-0.06340701451989703,-1,677182218034,9412.61,8309.29,-0.1172172224282,2019-11-18,0.075091965,0.019407213,0.9016109,0.2051442,23651,-81.46256158055621,11.808885636876429,-93.27144721743264
973,2019-11-19,8305.13,8408.52,8099.96,8206.15,8206.15,21083613816,BTC,8929.048571,8190.043374339362,9668.053767660636,0.0108975050063374,3.9310464686842500000,8791.395333,-0.06657024406617024,-1,656098604218,9342.53,8206.15,-0.1216351459401,2019-11-19,0.08727895,0.015116942,0.8940999,0.2490933,24542,-114.99928288927003,-13.552748068352871,-101.44653482091717
974,2019-11-20,8203.61,8237.24,8010.51,8027.27,8027.27,20764300437,BTC,8872.931429,8048.1692118419705,9697.69364615803,-0.012669840717234067,2.3351111207665000000,8703.711333,-0.07771872332613814,-1,635334303781,9360.88,8027.27,-0.1424663065866,2019-11-20,0.0885101,0.01360491,0.89444464,0.2701493,25579,-154.2335883831147,-41.68891613130525,-112.54467225180944
975,2019-11-21,8023.64,8110.10,7597.38,7642.75,7642.75,22514243371,BTC,8798.796667,7830.045366524316,9767.547967475684,-0.09666844650032907,0E-19,8589.169333,-0.11018752760686782,-1,612820060410,9267.56,7642.75,-0.1753223070582,2019-11-21,0.08032422,0.015897864,0.8992903,0.2154884,28746,-213.8890290021318,-76.12893870547057,-137.76009029666122
976,2019-11-22,7643.57,7697.38,6936.71,7296.58,7296.58,34242315785,BTC,8705.248095,7560.560546983179,9849.935643016823,-0.11530681339223393,0E-19,8457.770667,-0.13729275866164840,-1,578577744625,8804.88,7296.58,-0.1713027321213,2019-11-22,0.07527358,0.025159378,0.8949647,0.1734468,29333,-285.804841122419,-118.06411918886029,-167.74072193355875
977,2019-11-23,7296.16,7442.26,7151.42,7397.80,7397.80,21008924418,BTC,8613.490000,7372.48939685752,9854.49060314248,0.010197659484769205,1.4386423718695000000,8363.965333,-0.11551522448186120,1,599586669043,8813.58,7397.80,-0.1606362000458,2019-11-23,0.08785273,0.02281746,0.8860229,0.2396403,9072,-330.8175732266627,-160.6148099964208,-170.2027632302419
