,TradeDate,Open,High,Low,Close,Adj_Close,Volume,Ticker,stochastic_oscillator_sma,rolling_avg,price_to_SMA_ratio,multiplier,on_balance_volume,window_start_price,window_end_price,momentum
0,2017-03-21,1055.36,1122.43,1055.36,1120.54,1120.54,337391008,BTC,,1120.540000,0E-17,1,337391008,1120.54,1120.54,0E-13
1,2017-03-22,1120.65,1120.65,1014.21,1049.14,1049.14,380840992,BTC,0E-19,1084.840000,-0.03290807861067070,-1,-43449984,1120.54,1049.14,-0.0637192782052
2,2017-03-23,1050.05,1058.01,1028.93,1038.59,1038.59,248540000,BTC,0E-19,1069.423333,-0.02883173767445749,-1,-291989984,1120.54,1038.59,-0.0731343816374
3,2017-03-24,1038.45,1040.47,934.36,937.52,937.52,491038016,BTC,0E-19,1036.447500,-0.09544863584503798,-1,-783028000,1120.54,937.52,-0.1633319649455
4,2017-03-25,936.54,975.76,903.71,972.78,972.78,435803008,BTC,4.8164135067205000000,1023.714000,-0.04975413054818045,1,-347224992,1120.54,972.78,-0.1318649936638
5,2017-03-26,974.02,1007.96,954.19,966.72,966.72,303668000,BTC,8.8050486285650000000,1014.215000,-0.04682932119915403,-1,-650892992,1120.54,966.72,-0.1372731004694
6,2017-03-27,972.05,1046.40,971.98,1045.77,1045.77,372535008,BTC,23.5916839689650000000,1018.722857,0.02655005020663829,1,-278357984,1120.54,1045.77,-0.0667267567423
7,2017-03-28,1044.58,1064.65,1027.73,1047.15,1047.15,326332000,BTC,38.5668232980000000000,1022.276250,0.02433173029305924,1,47974016,1120.54,1047.15,-0.0654952076677
8,2017-03-29,1046.08,1055.13,1015.88,1039.97,1039.97,298457984,BTC,47.7447819910390000000,1024.242222,0.01535552593144320,-1,-250483968,1120.54,1039.97,-0.0719028325629
9,2017-03-30,1042.21,1049.29,1020.04,1026.43,1026.43,352968992,BTC,55.9009944268385000000,1024.461000,0.00192198629328008,-1,-603452960,1120.54,1026.43,-0.0839862923233
10,2017-03-31,1026.64,1074.92,1026.64,1071.79,1071.79,447287008,BTC,59.4552507922630000000,1028.763636,0.04182337175844734,1,-156165952,1120.54,1071.79,-0.0435058096989
11,2017-04-01,1071.71,1091.72,1061.09,1080.50,1080.50,289633984,BTC,64.0107638509452500000,1033.075000,0.04590663794981003,1,133468032,1120.54,1080.50,-0.0357327716994
12,2017-04-02,1080.61,1107.59,1075.45,1102.17,1102.17,514187008,BTC,72.5071030488472500000,1038.390000,0.06142200907173605,1,647655040,1120.54,1102.17,-0.0163938815214
13,2017-04-03,1102.95,1151.74,1102.95,1143.81,1143.81,580444032,BTC,85.3622554912032500000,1045.920000,0.09359224414869206,1,1228099072,1120.54,1143.81,0.0207667731629
14,2017-04-04,1145.52,1156.44,1120.52,1133.25,1133.25,436310016,BTC,90.7416119796682500000,1051.742000,0.07749809363893426,-1,791789056,1120.54,1133.25,0.0113427454620
15,2017-04-05,1134.14,1135.09,1113.63,1124.78,1124.78,414784000,BTC,93.9047401920770000000,1052.024667,0.06915744020287311,-1,377005056,1049.14,1124.78,0.0720971462341
16,2017-04-06,1125.81,1188.37,1125.81,1182.68,1182.68,511222016,BTC,96.4140287944155000000,1060.927333,0.11476060915097566,1,888227072,1038.59,1182.68,0.1387361711551
17,2017-04-07,1178.94,1186.58,1163.39,1176.90,1176.90,317022016,BTC,95.8246177975155000000,1070.148000,0.09975442649054150,-1,571205056,937.52,1176.90,0.2553332195580
18,2017-04-08,1172.65,1184.98,1162.58,1175.95,1175.95,209312000,BTC,96.3252901440670000000,1086.043333,0.08278368299692882,1,780517056,972.78,1175.95,0.2088550340262
19,2017-04-09,1176.57,1197.21,1171.86,1187.87,1187.87,242343008,BTC,98.6315095439410000000,1100.382667,0.07950628051832081,1,1022860064,966.72,1187.87,0.2287632406488
20,2017-04-10,1187.30,1190.34,1179.04,1187.13,1187.13,215883008,BTC,98.5169158868547500000,1115.076667,0.06461738025050075,-1,806977056,1045.77,1187.13,0.1351731260220
21,2017-04-11,1187.46,1208.07,1187.46,1205.01,1205.01,216182000,BTC,99.1063268837547500000,1125.692667,0.07046091293406285,1,1023159056,1047.15,1205.01,0.1507520412548
22,2017-04-12,1204.81,1207.14,1196.76,1200.37,1200.37,288702016,BTC,99.2358375222172500000,1135.907333,0.05674993472376853,-1,734457040,1039.97,1200.37,0.1542352183236
23,2017-04-13,1201.02,1205.89,1156.44,1169.28,1169.28,351968992,BTC,94.2338776162927500000,1144.528000,0.02162638222918094,-1,382488048,1026.43,1169.28,0.1391716921758
24,2017-04-14,1170.33,1190.80,1159.79,1167.54,1167.54,254827008,BTC,87.3168694117967500000,1153.935333,0.01178980018284959,-1,127661040,1071.79,1167.54,0.0893365304771
25,2017-04-15,1167.30,1188.00,1164.96,1172.52,1172.52,203559008,BTC,80.7932970079737500000,1160.650667,0.01022644740357522,1,331220048,1080.50,1172.52,0.0851642757982
26,2017-04-16,1172.61,1187.22,1172.61,1182.94,1182.94,183231008,BTC,76.0777355291760000000,1167.480000,0.01324219686846884,1,514451056,1102.17,1182.94,0.0732827059347
27,2017-04-17,1183.25,1194.90,1172.65,1193.91,1193.91,253206000,BTC,77.6208895021577500000,1173.596000,0.01730919328286736,1,767657056,1143.81,1193.91,0.0438009809321
28,2017-04-18,1193.77,1217.57,1193.77,1211.67,1211.67,270524000,BTC,84.6524913637400000000,1178.120000,0.02847757444063423,1,1038181056,1133.25,1211.67,0.0691992058240
29,2017-04-19,1212.13,1215.51,1205.08,1210.29,1210.29,288060992,BTC,90.7790100214472500000,1183.256000,0.02284712691082910,-1,750120064,1124.78,1210.29,0.0760237557567
30,2017-04-20,1211.08,1240.79,1208.41,1229.08,1229.08,315108000,BTC,96.1441403209415000000,1190.209333,0.03265868105909064,1,1065228064,1182.68,1229.08,0.0392329286028
31,2017-04-21,1229.42,1235.94,1215.56,1222.05,1222.05,272167008,BTC,96.7470801505367500000,1192.834000,0.02449293028200068,-1,793061056,1176.90,1222.05,0.0383634973235
32,2017-04-22,1222.71,1235.56,1208.47,1231.71,1231.71,249320000,BTC,96.7470801505367500000,1196.488000,0.02943782135717199,1,1042381056,1175.95,1231.71,0.0474169820145
33,2017-04-23,1231.92,1232.20,1203.94,1207.21,1207.21,258951008,BTC,87.5991751932085000000,1198.572000,0.00720690955570462,-1,783430048,1187.87,1207.21,0.0162812428970
34,2017-04-24,1209.63,1250.94,1209.63,1250.15,1250.15,235806000,BTC,87.5991751932085000000,1202.724000,0.03943215567328830,1,1019236048,1187.13,1250.15,0.0530860141686
35,2017-04-25,1250.45,1267.58,1249.97,1265.49,1265.49,242556000,BTC,90.4550412965560000000,1207.948000,0.04763615652329405,1,1261792048,1205.01,1265.49,0.0501904548510
36,2017-04-26,1265.99,1294.83,1265.93,1281.08,1281.08,329631008,BTC,90.4550412965560000000,1213.019333,0.05610847671460814,1,1591423056,1200.37,1281.08,0.0672376017395
37,2017-04-27,1281.88,1319.70,1281.30,1317.73,1317.73,449196992,BTC,100.0000000000000000000,1220.843333,0.07936044239347130,1,2040620048,1169.28,1317.73,0.1269584701697
38,2017-04-28,1317.74,1331.28,1292.37,1316.48,1316.48,527488992,BTC,99.7919302217192500000,1230.656667,0.06973783614987721,-1,1513131056,1167.54,1316.48,0.1275673638591
39,2017-04-29,1317.84,1327.20,1315.21,1321.79,1321.79,422705984,BTC,99.7919302217192500000,1240.940000,0.06515222331458411,1,1935837040,1172.52,1321.79,0.1273069968956
40,2017-04-30,1321.87,1347.91,1314.92,1347.89,1347.89,413115008,BTC,99.7919302217192500000,1252.631333,0.07604684993138360,1,2348952048,1182.94,1347.89,0.1394407155054
41,2017-05-01,1348.30,1434.32,1348.30,1421.60,1421.60,713624000,BTC,99.7919302217192500000,1268.542000,0.12065662784519551,1,3062576048,1193.91,1421.60,0.1907095174678
42,2017-05-02,1421.03,1473.90,1415.69,1452.82,1452.82,477337984,BTC,100.0000000000000000000,1285.802667,0.12989344110607604,1,3539914032,1211.67,1452.82,0.1990228362508
43,2017-05-03,1453.78,1492.77,1447.49,1490.09,1490.09,583795968,BTC,100.0000000000000000000,1304.364000,0.14238816772005360,1,4123710000,1210.29,1490.09,0.2311842616232
44,2017-05-04,1490.72,1608.91,1490.72,1537.67,1537.67,933548992,BTC,100.0000000000000000000,1326.189333,0.15946491329530246,1,5057258992,1229.08,1537.67,0.2510739740294
45,2017-05-05,1540.87,1618.03,1530.31,1555.45,1555.45,946035968,BTC,100.0000000000000000000,1347.947333,0.15393974372736119,1,6003294960,1222.05,1555.45,0.2728202610368
46,2017-05-06,1556.81,1578.80,1542.50,1578.80,1578.80,582529984,BTC,100.0000000000000000000,1371.730667,0.15095480328719661,1,6585824944,1231.71,1578.80,0.2817952277728
47,2017-05-07,1579.47,1596.72,1559.76,1596.71,1596.71,1080029952,BTC,100.0000000000000000000,1396.064000,0.14372263735759965,1,7665854896,1207.21,1596.71,0.3226447759710
48,2017-05-08,1596.92,1723.35,1596.92,1723.35,1723.35,1340320000,BTC,100.0000000000000000000,1430.473333,0.20474108831219995,1,9006174896,1250.15,1723.35,0.3785145782506
49,2017-05-09,1723.89,1833.49,1716.30,1755.36,1755.36,1167920000,BTC,100.0000000000000000000,1464.154000,0.19889028066719758,1,10174094896,1265.49,1755.36,0.3870990683451
50,2017-05-10,1756.52,1788.44,1719.10,1787.13,1787.13,915723008,BTC,100.0000000000000000000,1498.930000,0.19227048628021322,1,11089817904,1281.08,1787.13,0.3950182658382
51,2017-05-11,1780.37,1873.93,1755.35,1848.57,1848.57,799489984,BTC,100.0000000000000000000,1536.762667,0.20289882081056567,1,11889307888,1317.73,1848.57,0.4028442852481
52,2017-05-12,1845.76,1856.15,1694.01,1724.24,1724.24,740984000,BTC,94.1584130504237500000,1563.863333,0.10255158722363881,-1,11148323888,1316.48,1724.24,0.3097350510452
53,2017-05-13,1723.12,1812.99,1651.08,1804.91,1804.91,579635008,BTC,92.0863905742477500000,1596.425333,0.13059468719919142,1,11727958896,1321.79,1804.91,0.3655043539443
54,2017-05-14,1800.86,1831.42,1776.62,1808.91,1808.91,437196000,BTC,90.1060837914722500000,1628.900000,0.11051016023083062,1,12165154896,1347.89,1808.91,0.3420308778906
55,2017-05-15,1808.44,1812.80,1708.54,1738.43,1738.43,731529024,BTC,83.6571529532400000000,1654.936000,0.05045149782227228,-1,11433625872,1421.60,1738.43,0.2228685987620
56,2017-05-16,1741.70,1785.94,1686.54,1734.45,1734.45,959044992,BTC,82.2896432508895000000,1675.792667,0.03500273879644563,-1,10474580880,1452.82,1734.45,0.1938505802508
57,2017-05-17,1726.73,1864.05,1661.91,1839.09,1839.09,1064729984,BTC,83.7005409781255000000,1701.544000,0.08083599366222678,1,11539310864,1490.09,1839.09,0.2342140407626
58,2017-05-18,1818.70,1904.48,1807.12,1888.65,1888.65,894321024,BTC,85.6808477609010000000,1728.114667,0.09289622735433910,1,12433631888,1537.67,1888.65,0.2282544369078
59,2017-05-19,1897.37,2004.52,1890.25,1987.71,1987.71,1157289984,BTC,92.1297785991332500000,1758.117333,0.13059007080501834,1,13590921872,1555.45,1987.71,0.2779002860908
60,2017-05-20,1984.24,2084.73,1974.92,2084.73,2084.73,961336000,BTC,99.3388752510600000000,1793.402667,0.16244390529837436,1,14552257872,1578.80,2084.73,0.3204522422093
61,2017-05-21,2067.03,2119.08,2037.50,2041.20,2041.20,1147859968,BTC,97.7700708987337500000,1824.229333,0.11893826235278500,-1,13404397904,1596.71,2041.20,0.2783786661322
62,2017-05-22,2043.19,2303.90,2017.87,2173.40,2173.40,1942220032,BTC,97.7700708987337500000,1862.675333,0.16681633212995364,1,15346617936,1723.35,2173.40,0.2611483447936
63,2017-05-23,2191.56,2320.82,2178.50,2320.42,2320.42,1378749952,BTC,97.7700708987337500000,1902.480000,0.21968167865102393,1,16725367888,1755.36,2320.42,0.3219054780786
64,2017-05-24,2321.37,2523.72,2321.37,2443.64,2443.64,1725379968,BTC,97.7700708987337500000,1948.365333,0.25420010231725879,1,18450747856,1787.13,2443.64,0.3673543614622
65,2017-05-25,2446.24,2763.71,2285.30,2304.98,2304.98,2406700032,BTC,95.1814011676397500000,1982.888667,0.16243540969312525,-1,16044047824,1848.57,2304.98,0.2468989543269
66,2017-05-26,2320.89,2573.79,2071.99,2202.42,2202.42,1763480064,BTC,86.7987211565192500000,2006.478667,0.09765433155238226,-1,14280567760,1724.24,2202.42,0.2773279821835
67,2017-05-27,2196.27,2260.20,1855.83,2038.87,2038.87,1700480000,BTC,72.5299779424300000000,2027.454000,0.00563070728115163,-1,12580087760,1804.91,2038.87,0.1296241917880
68,2017-05-28,2054.08,2267.34,2054.08,2155.80,2155.80,1147139968,BTC,62.3831907626897500000,2050.846667,0.05117561185279972,1,13727227728,1808.91,2155.80,0.1917674179478
69,2017-05-29,2159.43,2307.05,2107.17,2255.61,2255.61,994625024,BTC,60.5734530420810000000,2080.626667,0.08410126418897812,1,14721852752,1738.43,2255.61,0.2974983174474
70,2017-05-30,2255.36,2301.96,2124.57,2175.47,2175.47,1443970048,BTC,59.5027425654620000000,2109.762667,0.03114441924097238,-1,13277882704,1734.45,2175.47,0.2542708063075
71,2017-05-31,2187.19,2311.08,2145.57,2286.41,2286.41,1544829952,BTC,67.2695421851422500000,2146.560000,0.06515075283243888,1,14822712656,1839.09,2286.41,0.2432289882496
72,2017-06-01,2288.33,2448.39,2288.33,2407.88,2407.88,1653180032,BTC,75.8054895299305000000,2184.479333,0.10226723760906371,1,16475892688,1888.65,2407.88,0.2749212400392
73,2017-06-02,2404.03,2488.55,2373.32,2488.55,2488.55,1317030016,BTC,82.4338260828995000000,2224.472667,0.11871457757947808,1,17792922704,1987.71,2488.55,0.2519683454830
74,2017-06-03,2493.72,2581.91,2423.57,2515.35,2515.35,1514950016,BTC,91.8872165706390000000,2259.648667,0.11315977423139825,1,19307872720,2084.73,2515.35,0.2065591227641
75,2017-06-04,2547.79,2585.89,2452.54,2511.81,2511.81,1355120000,BTC,98.2034230931877500000,2288.120667,0.09776116103757914,-1,17952752720,2041.20,2511.81,0.2305555555556
76,2017-06-05,2512.40,2686.81,2510.22,2686.81,2686.81,1369309952,BTC,99.8142629281397500000,2331.161333,0.15256287154622258,1,19322062672,2173.40,2686.81,0.2362243489464
77,2017-06-06,2690.84,2999.91,2690.84,2863.20,2863.20,2089609984,BTC,99.8142629281397500000,2377.148000,0.20446854802477591,1,21411672656,2320.42,2863.20,0.2339145499522
78,2017-06-07,2869.38,2869.38,2700.56,2732.16,2732.16,1517709952,BTC,95.8401263566210000000,2404.597333,0.13622350091827204,-1,19893962704,2443.64,2732.16,0.1180697647771
79,2017-06-08,2720.49,2815.30,2670.95,2805.62,2805.62,1281170048,BTC,94.2795967634320000000,2428.729333,0.15518018491358996,1,21175132752,2304.98,2805.62,0.2171992815556
80,2017-06-09,2807.44,2901.71,2795.62,2823.81,2823.81,1348950016,BTC,93.0849902344932500000,2463.318000,0.14634407737856014,1,22524082768,2202.42,2823.81,0.2821396463890
81,2017-06-10,2828.14,2950.99,2746.55,2947.71,2947.71,2018889984,BTC,93.0849902344932500000,2513.004000,0.17298261363690627,1,24542972752,2038.87,2947.71,0.4457567181821
82,2017-06-11,2942.41,2996.60,2840.53,2958.11,2958.11,1752400000,BTC,97.0591268060120000000,2574.286667,0.14909890880462692,1,26295372752,2155.80,2958.11,0.3721634659987
83,2017-06-12,2953.22,2997.26,2518.56,2659.63,2659.63,2569530112,BTC,89.2709970691395000000,2607.875333,0.01984552955622438,-1,23725842640,2255.61,2659.63,0.1791178439535
84,2017-06-13,2680.91,2789.04,2650.38,2717.02,2717.02,1781200000,BTC,82.7644255340897500000,2638.636000,0.02970625732385975,1,25507042640,2175.47,2717.02,0.2489347129586
85,2017-06-14,2716.88,2786.83,2412.94,2506.37,2506.37,1696560000,BTC,65.9511160209142500000,2660.696000,-0.05800211673937947,-1,23810482640,2286.41,2506.37,0.0962032181455
86,2017-06-15,2499.58,2534.71,2212.96,2464.58,2464.58,2026259968,BTC,43.5273114301067500000,2672.574000,-0.07782534739917398,-1,21784222672,2407.88,2464.58,0.0235476851006
87,2017-06-16,2469.57,2539.92,2385.15,2518.56,2518.56,1195190016,BTC,30.7960907469475000000,2679.952667,-0.06022220802155682,1,22979412688,2488.55,2518.56,0.0120592312793
88,2017-06-17,2514.01,2685.19,2484.96,2655.88,2655.88,1534509952,BTC,23.1876625053415000000,2691.108000,-0.01309051884948504,1,24513922640,2515.35,2655.88,0.0558689645576
89,2017-06-18,2655.35,2662.10,2516.33,2548.29,2548.29,1178659968,BTC,19.2413424114010000000,2693.304000,-0.05384241808574153,-1,23335262672,2511.81,2548.29,0.0145233914986
90,2017-06-19,2549.03,2662.85,2549.03,2589.60,2589.60,1446840064,BTC,22.9980953538790000000,2698.490000,-0.04035219696941623,1,24782102736,2686.81,2589.60,-0.0361804519114
91,2017-06-20,2591.26,2763.45,2589.82,2721.79,2721.79,1854189952,BTC,33.2928089477842500000,2700.822000,0.00776356235249861,1,26636292688,2863.20,2721.79,-0.0493887957530
92,2017-06-21,2709.43,2772.01,2660.40,2689.10,2689.10,1626579968,BTC,34.9755840577067500000,2689.215333,-0.00004288723129930,-1,25009712720,2732.16,2689.10,-0.0157604239869
93,2017-06-22,2691.03,2723.74,2642.36,2705.41,2705.41,1097939968,BTC,42.9345733795310000000,2687.432000,0.00668965763598856,1,26107652688,2805.62,2705.41,-0.0357175953978
94,2017-06-23,2707.34,2765.17,2706.37,2744.91,2744.91,961318976,BTC,50.8018762790510000000,2683.384667,0.02292825689757882,1,27068971664,2823.81,2744.91,-0.0279409733658
95,2017-06-24,2738.52,2757.94,2583.19,2608.72,2608.72,982750016,BTC,45.0742609365185000000,2669.045333,-0.02260183903740387,-1,26086221648,2947.71,2608.72,-0.1150011364754
96,2017-06-25,2607.25,2682.26,2552.12,2589.41,2589.41,1161100032,BTC,40.0244159422932500000,2645.158667,-0.02107573647490387,-1,24925121616,2958.11,2589.41,-0.1246403953876
97,2017-06-26,2590.57,2615.25,2376.29,2478.45,2478.45,1663280000,BTC,29.0619912684297500000,2613.181333,-0.05155835582421099,-1,23261841616,2659.63,2478.45,-0.0681222576073
98,2017-06-27,2478.45,2552.45,2332.99,2552.45,2552.45,1489789952,BTC,22.6980400921510000000,2606.036000,-0.02056226391346858,1,24751631568,2717.02,2552.45,-0.0605700362898
99,2017-06-28,2553.03,2603.98,2484.42,2574.79,2574.79,1183869952,BTC,25.2251537961907500000,2596.554000,-0.00838187844350628,1,25935501520,2506.37,2574.79,0.0272984435658
100,2017-06-29,2567.56,2588.83,2510.48,2539.32,2539.32,949979008,BTC,25.5671886704957500000,2598.750667,-0.02286893766095953,-1,24985522512,2464.58,2539.32,0.0303256538639
101,2017-06-30,2539.24,2559.25,2478.43,2480.84,2480.84,860273024,BTC,24.5544899127705000000,2599.834667,-0.04577009011781133,-1,24125249488,2518.56,2480.84,-0.0149768121466
102,2017-07-01,2492.60,2515.27,2419.23,2434.55,2434.55,779913984,BTC,16.7181898378587500000,2594.234000,-0.06155342964435745,-1,23345335504,2655.88,2434.55,-0.0833358434869
103,2017-07-02,2436.40,2514.28,2394.84,2506.47,2506.47,803747008,BTC,12.6828672964355000000,2584.273333,-0.03010646436136870,1,24149082512,2548.29,2506.47,-0.0164110050269
104,2017-07-03,2498.56,2595.00,2480.47,2564.06,2564.06,964112000,BTC,16.4497485914065000000,2585.324667,-0.00822514373975143,1,25113194512,2589.60,2564.06,-0.0098625270312
105,2017-07-04,2561.00,2631.59,2559.35,2601.64,2601.64,985516032,BTC,29.6848820724317500000,2586.127333,0.00599841577870211,1,26098710544,2721.79,2601.64,-0.0441437436393
106,2017-07-05,2602.87,2622.65,2538.55,2601.99,2601.99,941566016,BTC,43.1724449026935000000,2578.140667,0.00925059416084995,-1,25157144528,2689.10,2601.99,-0.0323937376818
107,2017-07-06,2608.10,2616.72,2581.69,2608.56,2608.56,761956992,BTC,51.3959595308672500000,2572.771333,0.01391055106256503,1,25919101520,2705.41,2608.56,-0.0357986405018
108,2017-07-07,2608.59,2916.14,2498.87,2518.66,2518.66,917411968,BTC,47.7389160974352500000,2560.321333,-0.01627191574082002,-1,25001689552,2744.91,2518.66,-0.0824252889894
109,2017-07-08,2520.27,2571.34,2492.31,2571.34,2571.34,733329984,BTC,53.9140987820475000000,2548.750000,0.00886316821971555,1,25735019536,2608.72,2571.34,-0.0143288662639
110,2017-07-09,2572.61,2635.49,2517.59,2518.44,2518.44,527856000,BTC,52.4790042007370000000,2542.731333,-0.00955324405875798,-1,25207163536,2589.41,2518.44,-0.0274077878745
111,2017-07-10,2525.25,2537.16,2321.13,2372.56,2372.56,1111200000,BTC,38.4622172436550000000,2528.274667,-0.06158930002046332,-1,24095963536,2478.45,2372.56,-0.0427242833222
112,2017-07-11,2385.89,2413.47,2296.81,2337.79,2337.79,1329760000,BTC,31.6870206977082500000,2518.897333,-0.07189945005988063,-1,22766203536,2552.45,2337.79,-0.0840995905894
113,2017-07-12,2332.77,2423.71,2275.14,2398.84,2398.84,1117410048,BTC,17.6891709855912500000,2508.656667,-0.04377508825523154,1,23883613584,2574.79,2398.84,-0.0683356700935
114,2017-07-13,2402.70,2425.22,2340.83,2357.90,2357.90,835769984,BTC,7.4934446208960000000,2494.197333,-0.05464576968176880,-1,23047843600,2539.32,2357.90,-0.0714443236772
115,2017-07-14,2360.59,2363.25,2183.22,2233.34,2233.34,882502976,BTC,7.4934446208960000000,2473.798667,-0.09720219765968529,-1,22165340624,2480.84,2233.34,-0.0997645958627
116,2017-07-15,2230.12,2231.14,1990.41,1998.86,1998.86,993608000,BTC,7.4934446208960000000,2441.666667,-0.18135426632336461,-1,21171732624,2434.55,1998.86,-0.1789612043293
117,2017-07-16,1991.98,2058.77,1843.03,1929.82,1929.82,1182870016,BTC,1.8567418842560000000,2408.018000,-0.19858572485753844,-1,19988862608,2506.47,1929.82,-0.2300645928337
118,2017-07-17,1932.62,2230.49,1932.62,2228.41,2228.41,1201760000,BTC,10.9979520876920000000,2389.480667,-0.06740823193276751,1,21190622608,2564.06,2228.41,-0.1309056730342
119,2017-07-18,2233.52,2387.61,2164.77,2318.88,2318.88,1512450048,BTC,25.3281816306687500000,2373.135333,-0.02286230045355782,1,22703072656,2601.64,2318.88,-0.1086852908166
120,2017-07-19,2323.08,2397.17,2260.23,2273.43,2273.43,1245100032,BTC,37.9843533606390000000,2351.254667,-0.03309920787921184,-1,21457972624,2601.99,2273.43,-0.1262725836763
121,2017-07-20,2269.89,2900.70,2269.89,2817.60,2817.60,2249260032,BTC,62.9843533606390000000,2365.628667,0.19105759889745198,1,23707232656,2608.56,2817.60,0.0801361670807
122,2017-07-21,2838.41,2838.41,2621.85,2667.76,2667.76,1489449984,BTC,72.7668874294272500000,2369.575333,0.12583886354964854,-1,22217782672,2518.66,2667.76,0.0591981450454
123,2017-07-22,2668.63,2862.42,2657.71,2810.12,2810.12,1177129984,BTC,83.2260201158317500000,2389.006000,0.17627163766018168,1,23394912656,2571.34,2810.12,0.0928620874719
124,2017-07-23,2808.10,2832.18,2653.94,2730.40,2730.40,1072840000,BTC,93.1142850706257500000,2399.610000,0.13785156754639296,-1,22322072656,2518.44,2730.40,0.0841632121472
125,2017-07-24,2732.70,2777.26,2699.19,2754.86,2754.86,866473984,BTC,91.3475185293655000000,2415.371333,0.14055340574831605,1,23188546640,2372.56,2754.86,0.1611339649998
126,2017-07-25,2757.50,2768.08,2480.96,2576.48,2576.48,1460089984,BTC,88.7770618847012500000,2428.966000,0.06073119179107489,-1,21728456656,2337.79,2576.48,0.1021007019450
127,2017-07-26,2577.77,2610.76,2450.80,2529.45,2529.45,937404032,BTC,80.8733582644347500000,2441.743333,0.03591969140025906,-1,20791052624,2398.84,2529.45,0.0544471494556
128,2017-07-27,2538.71,2693.32,2529.34,2671.78,2671.78,789104000,BTC,79.2226114577935000000,2459.939333,0.08611621602133226,1,21580156624,2357.90,2671.78,0.1331184528606
129,2017-07-28,2679.73,2897.45,2679.73,2809.01,2809.01,1380099968,BTC,80.7474824843992500000,2490.013333,0.12811042526253011,1,22960256592,2233.34,2809.01,0.2577619171286
130,2017-07-29,2807.02,2808.76,2692.80,2726.45,2726.45,803745984,BTC,84.9706571447880000000,2522.887333,0.08068638830491920,-1,22156510608,1998.86,2726.45,0.3640024814144
131,2017-07-30,2724.39,2758.53,2644.85,2757.18,2757.18,705942976,BTC,91.3835634954605000000,2573.442000,0.07139776221884931,1,22862453584,1929.82,2757.18,0.4287239224384
132,2017-07-31,2763.24,2889.62,2720.61,2875.34,2875.34,860574976,BTC,95.4898736173375000000,2636.476667,0.09059944887424259,1,23723028560,2228.41,2875.34,0.2903101314390
133,2017-08-01,2871.30,2921.35,2685.61,2718.26,2718.26,1324669952,BTC,89.2075379346370000000,2669.133333,0.01840547506286753,-1,22398358608,2318.88,2718.26,0.1722296970951
134,2017-08-02,2727.13,2762.53,2668.59,2710.67,2710.67,1094950016,BTC,84.9348560996587500000,2695.252667,0.00572018096439194,-1,21303408592,2273.43,2710.67,0.1923261327598
135,2017-08-03,2709.56,2813.31,2685.14,2804.73,2804.73,804796992,BTC,81.5327900268007500000,2730.672667,0.02712054575232616,1,22108205584,2817.60,2804.73,-0.0045677172061
136,2017-08-04,2806.93,2899.33,2743.72,2895.89,2895.89,1002120000,BTC,81.5327900268007500000,2735.892000,0.05848110963444463,1,23110325584,2667.76,2895.89,0.0855136893874
137,2017-08-05,2897.63,3290.01,2874.83,3252.91,3252.91,1945699968,BTC,88.0570212241557500000,2774.902000,0.17226121859438640,1,25056025552,2810.12,3252.91,0.1575697834968
138,2017-08-06,3257.61,3293.29,3155.60,3213.94,3213.94,1105030016,BTC,93.5498453055287500000,2801.823333,0.14708874115868461,-1,23950995536,2730.40,3213.94,0.1770949311456
139,2017-08-07,3212.78,3397.68,3180.89,3378.94,3378.94,1482279936,BTC,98.6533464185995000000,2845.059333,0.18765185696041159,1,25433275472,2754.86,3378.94,0.2265378276936
140,2017-08-08,3370.22,3484.85,3345.83,3419.94,3419.94,1752760064,BTC,98.6533464185995000000,2889.398000,0.18361679491714191,1,27186035536,2576.48,3419.94,0.3273691237658
141,2017-08-09,3420.40,3422.76,3247.67,3342.47,3342.47,1468960000,BTC,96.4784202543527500000,2940.464000,0.13671515787984481,-1,25717075536,2529.45,3342.47,0.3214216529285
142,2017-08-10,3341.84,3453.45,3319.47,3381.28,3381.28,1515110016,BTC,96.5332378648380000000,2997.252667,0.12812644633806577,1,27232185552,2671.78,3381.28,0.2655533015443
143,2017-08-11,3373.82,3679.72,3372.12,3650.62,3650.62,2021190016,BTC,96.5332378648380000000,3062.508667,0.19203581016347210,1,29253375568,2809.01,3650.62,0.2996108949416
144,2017-08-12,3650.63,3949.92,3613.70,3884.71,3884.71,2219589888,BTC,96.5332378648380000000,3134.222000,0.23944953484469192,1,31472965456,2726.45,3884.71,0.4248234884190
145,2017-08-13,3880.04,4208.39,3857.80,4073.26,4073.26,3159089920,BTC,98.7081640290847500000,3224.009333,0.26341445674716972,1,34632055376,2757.18,4073.26,0.4773282846967
146,2017-08-14,4066.10,4325.13,3989.16,4325.13,4325.13,2463089920,BTC,100.0000000000000000000,3328.539333,0.29940780844003925,1,37095145296,2875.34,4325.13,0.5042151536862
147,2017-08-15,4326.99,4455.97,3906.18,4181.93,4181.93,3258050048,BTC,97.7825402921100000000,3415.645333,0.22434550203342204,-1,33837095248,2718.26,4181.93,0.5384584256105
148,2017-08-16,4200.34,4381.23,3994.42,4376.63,4376.63,2272039936,BTC,97.7825402921100000000,3526.203333,0.24117346241530536,1,36109135184,2710.67,4376.63,0.6145934399982
149,2017-08-17,4384.44,4484.70,4243.71,4331.69,4331.69,2553359872,BTC,97.0678001686925000000,3634.271333,0.19190054982061517,-1,33555775312,2804.73,4331.69,0.5444231708578
150,2017-08-18,4324.34,4370.13,4015.40,4160.62,4160.62,2941710080,BTC,93.4208060981602500000,3724.664000,0.11704572546678036,-1,30614065232,2895.89,4160.62,0.4367327488268
151,2017-08-19,4137.75,4243.26,3970.55,4193.70,4193.70,2975820032,BTC,91.7049301791850000000,3811.184667,0.10036651761120239,1,33589885264,3252.91,4193.70,0.2892148875930
152,2017-08-20,4189.31,4196.29,4069.88,4087.66,4087.66,2109769984,BTC,85.4915370993442500000,3866.834667,0.05710751868564439,-1,31480115280,3213.94,4087.66,0.2718532393262
153,2017-08-21,4090.48,4109.14,3988.60,4001.74,4001.74,2800890112,BTC,77.1436080032985000000,3919.354667,0.02102012703613281,-1,28679225168,3378.94,4001.74,0.1843181589493
154,2017-08-22,3998.35,4128.76,3674.58,4100.52,4100.52,3764239872,BTC,74.1158612213515000000,3967.460000,0.03353783024907624,1,32443465040,3419.94,4100.52,0.1990034912893
155,2017-08-23,4089.01,4255.78,4078.41,4151.52,4151.52,2369819904,BTC,72.6073406557512500000,4016.232000,0.03368530503217942,1,34813284944,3342.47,4151.52,0.2420515367378
156,2017-08-24,4137.60,4376.39,4130.26,4334.68,4334.68,2037750016,BTC,77.7670842655562500000,4082.379333,0.06180235750277349,1,36851034960,3381.28,4334.68,0.2819642265651
157,2017-08-25,4332.82,4455.70,4307.35,4371.60,4371.60,1727970048,BTC,86.6565465043995000000,4148.400667,0.05380370675752762,1,38579005008,3650.62,4371.60,0.1974952199900
158,2017-08-26,4372.06,4379.28,4269.52,4352.40,4352.40,1511609984,BTC,92.0998879423397500000,4195.186000,0.03747485808734106,-1,37067395024,3884.71,4352.40,0.1203925132121
159,2017-08-27,4345.10,4416.59,4317.29,4382.88,4382.88,1537459968,BTC,97.5417441348052500000,4228.397333,0.03653456731569649,1,38604854992,4073.26,4382.88,0.0760128251081
160,2017-08-28,4384.45,4403.93,4224.64,4382.66,4382.66,1959330048,BTC,98.5809632118095000000,4249.024000,0.03145098733262039,-1,36645524944,4325.13,4382.66,0.0133013342952
161,2017-08-29,4389.21,4625.68,4352.13,4579.02,4579.02,2486080000,BTC,98.7541701924295000000,4265.950000,0.07338810815879230,1,39131604944,4181.93,4579.02,0.0949537653667
162,2017-08-30,4570.36,4626.52,4471.41,4565.30,4565.30,1937849984,BTC,99.3914038641747500000,4291.508000,0.06379855286300294,-1,37193754960,4376.63,4565.30,0.0431085104293
163,2017-08-31,4555.59,4736.05,4549.40,4703.39,4703.39,1944930048,BTC,99.3914038641747500000,4313.292000,0.09044089757892579,1,39138685008,4331.69,4703.39,0.0858094646662
164,2017-09-01,4701.76,4892.01,4678.53,4892.01,4892.01,2599079936,BTC,99.4058342572062500000,4350.646667,0.12443284284754352,1,41737764944,4160.62,4892.01,0.1757887045681
165,2017-09-02,4901.42,4975.04,4469.24,4578.77,4578.77,2722139904,BTC,90.6096263652185000000,4378.523333,0.04573383576393973,-1,39015625040,4193.70,4578.77,0.0918210649307
166,2017-09-03,4585.27,4714.08,4417.59,4582.96,4582.96,1933190016,BTC,82.5252451503477500000,4404.474000,0.04052379466878451,-1,37082435024,4087.66,4582.96,0.1211695688976
167,2017-09-04,4591.63,4591.63,4108.40,4236.31,4236.31,2987330048,BTC,64.1122917766522500000,4414.384000,-0.04033949017575272,-1,34095104976,4001.74,4236.31,0.0586170016043
168,2017-09-05,4228.29,4427.84,3998.11,4376.53,4376.53,2697969920,BTC,47.8303425416650000000,4439.370000,-0.01415516165582053,1,36793074896,4100.52,4376.53,0.0673109751934
169,2017-09-06,4376.59,4617.25,4376.59,4597.12,4597.12,2172100096,BTC,46.6706428589387500000,4472.476667,0.02786897334080603,1,38965174992,4151.52,4597.12,0.1073341812156
170,2017-09-07,4589.14,4655.04,4491.33,4599.88,4599.88,1844620032,BTC,44.2110931260435000000,4502.367333,0.02165808779867496,1,40809795024,4334.68,4599.88,0.0611809868318
171,2017-09-08,4605.16,4661.00,4075.18,4228.75,4228.75,2700890112,BTC,37.6240464997390000000,4495.305333,-0.05929637994625626,-1,38108904912,4371.60,4228.75,-0.0326768231311
172,2017-09-09,4229.81,4308.82,4114.11,4226.06,4226.06,1386230016,BTC,28.9059957347262500000,4485.602667,-0.05786126999375623,-1,36722674896,4352.40,4226.06,-0.0290276628986
173,2017-09-10,4229.34,4245.44,3951.04,4122.94,4122.94,1679090048,BTC,13.8619033094402500000,4470.305333,-0.07770505751267885,-1,35043584848,4382.88,4122.94,-0.0593080348994
174,2017-09-11,4122.47,4261.67,4099.40,4161.27,4161.27,1557330048,BTC,1.2459854109510000000,4455.531333,-0.06604404974566027,1,36600914896,4382.66,4161.27,-0.0505149840508
175,2017-09-12,4168.88,4344.65,4085.22,4130.81,4130.81,1864530048,BTC,1.5018138791007500000,4438.741333,-0.06937357009534937,-1,34736384848,4579.02,4130.81,-0.0978833898957
176,2017-09-13,4131.98,4131.98,3789.92,3882.59,3882.59,2219409920,BTC,1.5018138791007500000,4392.312667,-0.11604881201413797,-1,32516974928,4565.30,3882.59,-0.1495432939785
177,2017-09-14,3875.37,3920.60,3153.86,3154.95,3154.95,2716310016,BTC,1.5018138791007500000,4298.289333,-0.26599869027476657,-1,29800664912,4703.39,3154.95,-0.3292178620102
178,2017-09-15,3166.30,3733.45,2946.62,3637.52,3637.52,4148069888,BTC,7.2010404930655000000,4227.231333,-0.13950297169601340,1,33948734800,4892.01,3637.52,-0.2564365158698
179,2017-09-16,3637.75,3808.84,3487.79,3625.04,3625.04,1818400000,BTC,15.0786510150397500000,4142.766667,-0.12497123507438900,-1,32130334800,4578.77,3625.04,-0.2082939304660
180,2017-09-17,3606.28,3664.81,3445.64,3582.88,3582.88,1239149952,BTC,22.4826429039202500000,4076.374000,-0.12106200265235722,-1,30891184848,4582.96,3582.88,-0.2182170474977
181,2017-09-18,3591.09,4079.23,3591.09,4065.20,4065.20,1943209984,BTC,38.2316757290397500000,4041.856667,0.00577539851687175,1,32834394832,4236.31,4065.20,-0.0403912839240
182,2017-09-19,4073.79,4094.07,3868.87,3924.97,3924.97,1563980032,BTC,44.6092544275500000000,4021.100667,-0.02390655568235740,-1,31270414800,4376.53,3924.97,-0.1031776315940
183,2017-09-20,3916.36,4031.39,3857.73,3905.95,3905.95,1213830016,BTC,49.4695244752340000000,3989.728667,-0.02099858762149752,-1,30056584784,4597.12,3905.95,-0.1503484790478
184,2017-09-21,3901.47,3916.42,3613.63,3631.04,3631.04,1411480064,BTC,50.3027828337702500000,3925.323333,-0.07497046944540199,-1,28645104720,4599.88,3631.04,-0.2106228858144
185,2017-09-22,3628.02,3758.27,3553.53,3630.70,3630.70,1194829952,BTC,45.6300677586972500000,3860.711333,-0.05957744911771677,1,29839934672,4228.75,3630.70,-0.1414247709134
186,2017-09-23,3629.92,3819.21,3594.58,3792.40,3792.40,928113984,BTC,47.1855341703927500000,3831.621333,-0.01023622367435023,1,30768048656,4226.06,3792.40,-0.1026156751206
187,2017-09-24,3796.15,3796.15,3666.90,3682.84,3682.84,768014976,BTC,47.3061923318852500000,3795.406667,-0.02965865765551178,-1,30000033680,4122.94,3682.84,-0.1067442165057
188,2017-09-25,3681.58,3950.25,3681.58,3926.07,3926.07,1374210048,BTC,58.2258702981580000000,3782.282000,0.03801620291665190,1,31374243728,4161.27,3926.07,-0.0565212062664
189,2017-09-26,3928.41,3969.89,3869.90,3892.35,3892.35,1043740032,BTC,66.0405819990572500000,3764.354000,0.03400211563524578,-1,30330503696,4130.81,3892.35,-0.0577271769943
190,2017-09-27,3892.94,4210.05,3884.82,4200.67,4200.67,1686880000,BTC,76.1623248639357500000,3769.011333,0.11452835474931165,1,32017383696,3882.59,4200.67,0.0819246945982
191,2017-09-28,4197.13,4279.31,4109.70,4174.73,4174.73,1712320000,BTC,87.4278107801920000000,3788.487333,0.10195168494707489,-1,30305063696,3154.95,4174.73,0.3232317469374
192,2017-09-29,4171.62,4214.63,4039.29,4163.07,4163.07,1367049984,BTC,91.7493299353495000000,3855.695333,0.07971964599206055,-1,28938013712,3637.52,4163.07,0.1444803052629
193,2017-09-30,4166.11,4358.43,4160.86,4338.71,4338.71,1207449984,BTC,97.8583004844037500000,3902.441333,0.11179377978364601,1,30145463696,3625.04,4338.71,0.1968723103745
194,2017-10-01,4341.05,4403.74,4269.81,4403.74,4403.74,1208210048,BTC,97.8583004844037500000,3954.354667,0.11364315314208512,1,31353673744,3582.88,4403.74,0.2291061938999
195,2017-10-02,4395.81,4470.23,4377.46,4409.32,4409.32,1431730048,BTC,98.4784473688470000000,4009.450667,0.09973170047736118,1,32785403792,4065.20,4409.32,0.0846502017121
196,2017-10-03,4408.46,4432.47,4258.89,4317.48,4317.48,1288019968,BTC,97.0511931365750000000,4026.269333,0.07232766685854495,-1,31497383824,3924.97,4317.48,0.1000033121272
197,2017-10-04,4319.37,4352.31,4210.42,4229.36,4229.36,1116770048,BTC,91.2730214995762500000,4046.562000,0.04517365605667231,-1,30380613776,3905.95,4229.36,0.0827993189877
198,2017-10-05,4229.88,4362.64,4164.05,4328.41,4328.41,1161769984,BTC,88.6751560453110000000,4074.726000,0.06225792850856720,1,31542383760,3631.04,4328.41,0.1920579227990
199,2017-10-06,4324.46,4413.27,4320.53,4370.81,4370.81,1069939968,BTC,87.4386735506410000000,4124.044000,0.05983592803568536,1,32612323728,3630.70,4370.81,0.2038477428595
200,2017-10-07,4369.35,4443.88,4321.05,4426.89,4426.89,906928000,BTC,90.3874804140660000000,4177.123333,0.05979394120992309,1,33519251728,3792.40,4426.89,0.1673056639595
201,2017-10-08,4429.67,4624.14,4405.64,4610.48,4610.48,1313869952,BTC,96.1656520510647500000,4231.662000,0.08951990967142461,1,34833121680,3682.84,4610.48,0.2518816999924
202,2017-10-09,4614.52,4878.71,4564.25,4772.02,4772.02,1968739968,BTC,98.7635175053300000000,4304.274000,0.10867012648358353,1,36801861648,3926.07,4772.02,0.2154699228491
203,2017-10-10,4776.21,4922.17,4765.10,4781.99,4781.99,1597139968,BTC,100.0000000000000000000,4361.335333,0.09645088829036389,1,38399001616,3892.35,4781.99,0.2285611520033
204,2017-10-11,4789.25,4873.73,4751.63,4826.48,4826.48,1222279936,BTC,100.0000000000000000000,4423.610667,0.09107251142271468,1,39621281552,4200.67,4826.48,0.1489786153161
205,2017-10-12,4829.58,5446.91,4822.00,5446.91,5446.91,2791610112,BTC,100.0000000000000000000,4506.693333,0.20862672419161919,1,42412891664,4174.73,5446.91,0.3047334797699
206,2017-10-13,5464.16,5840.30,5436.85,5647.21,5647.21,3615480064,BTC,100.0000000000000000000,4604.858667,0.22635902823030117,1,46028371728,4163.07,5647.21,0.3565013319497
207,2017-10-14,5643.53,5837.70,5591.64,5831.79,5831.79,1669030016,BTC,100.0000000000000000000,4716.106667,0.23656872326632641,1,47697401744,4338.71,5831.79,0.3441299372394
208,2017-10-15,5835.96,5852.48,5478.61,5678.19,5678.19,1976039936,BTC,97.6036394725510000000,4805.405333,0.18162560835531499,-1,45721361808,4403.74,5678.19,0.2894017357973
209,2017-10-16,5687.57,5776.23,5544.21,5725.59,5725.59,2008070016,BTC,95.9467808266195000000,4893.528667,0.17003299451602048,1,47729431824,4409.32,5725.59,0.2985199531901
210,2017-10-17,5741.58,5800.35,5472.72,5605.51,5605.51,1821570048,BTC,92.4165174141772500000,4973.274667,0.12712656656491882,-1,45907861776,4317.48,5605.51,0.2983291179114
211,2017-10-18,5603.82,5603.82,5151.44,5590.69,5590.69,2399269888,BTC,88.6550426539692500000,5058.155333,0.10528238694562843,-1,43508591888,4229.36,5590.69,0.3218761231014
212,2017-10-19,5583.74,5744.35,5531.06,5708.52,5708.52,1780540032,BTC,89.0015222464582500000,5156.766000,0.10699612896920279,1,45289131920,4328.41,5708.52,0.3188491848046
213,2017-10-20,5708.11,6060.11,5627.23,6011.45,6011.45,2354429952,BTC,90.6583808923897500000,5268.968667,0.14091587555838468,1,47643561872,4370.81,6011.45,0.3753629190013
214,2017-10-21,5996.79,6194.88,5965.07,6031.60,6031.60,2207099904,BTC,94.1886443048320000000,5379.688000,0.12118026175495679,1,49850661776,4426.89,6031.60,0.3624915008053
215,2017-10-22,6036.66,6076.26,5792.34,6008.42,6008.42,2034630016,BTC,97.5423421003925000000,5485.123333,0.09540289893787881,-1,47816031760,4610.48,6008.42,0.3032092103208
216,2017-10-23,6006.00,6075.59,5732.47,5930.32,5930.32,2401840128,BTC,97.5820291612040000000,5573.112667,0.06409476253999442,-1,45414191632,4772.02,5930.32,0.2427273984602
217,2017-10-24,5935.52,5935.52,5504.18,5526.64,5526.64,2735699968,BTC,87.4796772274007500000,5623.420667,-0.01721028404791756,-1,42678491664,4781.99,5526.64,0.1557196899199
218,2017-10-25,5524.60,5754.33,5397.88,5750.80,5750.80,1966989952,BTC,81.6545311838532500000,5688.008000,0.01103936562677127,1,44645481616,4826.48,5750.80,0.1915101689016
219,2017-10-26,5747.95,5976.80,5721.22,5904.83,5904.83,1905040000,BTC,76.6419144355930000000,5759.898000,0.02516225113708611,1,46550521616,5446.91,5904.83,0.0840696835453
220,2017-10-27,5899.74,5988.39,5728.82,5780.90,5780.90,1710130048,BTC,66.2402341018835000000,5782.164000,-0.00021860327725052,-1,44840391568,5647.21,5780.90,0.0236736370703
221,2017-10-28,5787.82,5876.72,5689.19,5753.09,5753.09,1403920000,BTC,62.5538700977907500000,5789.222667,-0.00624136763748355,-1,43436471568,5831.79,5753.09,-0.0134949989626
222,2017-10-29,5754.44,6255.71,5724.58,6153.85,6153.85,2859040000,BTC,68.3790161413382500000,5810.693333,0.05905606221742076,1,46295511568,5678.19,6153.85,0.0837696519489
223,2017-10-30,6114.85,6214.99,6040.85,6130.53,6130.53,1772150016,BTC,72.8698966130667500000,5840.849333,0.04959564105914252,1,48067661584,5725.59,6130.53,0.0707245890816
224,2017-10-31,6132.02,6470.43,6103.33,6468.40,6468.40,2311379968,BTC,85.2817708209247500000,5890.370000,0.09813135677385292,1,50379041552,5605.51,6468.40,0.1539360379341
225,2017-11-01,6440.97,6767.31,6377.88,6767.31,6767.31,2870320128,BTC,99.0704867588207500000,5967.823333,0.13396620884856211,1,53249361680,5590.69,6767.31,0.2104606050416
226,2017-11-02,6777.77,7367.33,6758.72,7078.50,7078.50,4653770240,BTC,99.0704867588207500000,6067.010667,0.16671955737637736,1,57903131920,5708.52,7078.50,0.2399886485464
227,2017-11-03,7087.53,7461.29,7002.94,7207.76,7207.76,3369860096,BTC,100.0000000000000000000,6166.960000,0.16877035038333312,1,61272992016,6011.45,7207.76,0.1990052316829
228,2017-11-04,7164.48,7492.86,7031.28,7379.95,7379.95,2483800064,BTC,100.0000000000000000000,6258.193333,0.17924608705916436,1,63756792080,6031.60,7379.95,0.2235476490483
229,2017-11-05,7404.52,7617.48,7333.19,7407.41,7407.41,2380410112,BTC,100.0000000000000000000,6349.914000,0.16653705861213238,1,66137202192,6008.42,7407.41,0.2328382503220
230,2017-11-06,7403.22,7445.77,7007.31,7022.76,7022.76,3111899904,BTC,94.8870675308517500000,6417.536667,0.09430773276484031,-1,63025302288,5930.32,7022.76,0.1842126563153
231,2017-11-07,7023.10,7253.32,7023.10,7144.38,7144.38,2326340096,BTC,91.3907601673782500000,6498.474000,0.09939348837896405,1,65351642384,5526.64,7144.38,0.2927167320470
232,2017-11-08,7141.38,7776.42,7114.02,7459.69,7459.69,4602200064,BTC,91.3907601673782500000,6627.344000,0.12559269595783771,1,69953842448,5750.80,7459.69,0.2971569172985
233,2017-11-09,7446.83,7446.83,7101.52,7143.58,7143.58,3226249984,BTC,86.7600617025945000000,6720.196000,0.06300173387799999,-1,66727592464,5904.83,7143.58,0.2097858871466
234,2017-11-10,7173.73,7312.00,6436.87,6618.14,6618.14,5208249856,BTC,79.5451200360342500000,6767.750000,-0.02210631302870230,-1,61519342608,5780.90,6618.14,0.1448286598972
235,2017-11-11,6618.61,6873.15,6204.22,6357.60,6357.60,4908680192,BTC,66.8969002695417500000,6806.196667,-0.06591003594930355,-1,56610662416,5753.09,6357.60,0.1050757071417
236,2017-11-12,6295.45,6625.05,5519.01,5950.07,5950.07,8957349888,BTC,41.8969002695417500000,6819.328667,-0.12746983016180235,-1,47653312528,6153.85,5950.07,-0.0331142293036
237,2017-11-13,5938.25,6811.19,5844.29,6559.49,6559.49,6263249920,BTC,31.6198736114470000000,6846.371333,-0.04190268377895476,1,53916562448,6130.53,6559.49,0.0699711117962
238,2017-11-14,6561.48,6764.98,6461.75,6635.75,6635.75,3197110016,BTC,30.3029232217782500000,6880.052667,-0.03550883675233936,1,57113672464,6468.40,6635.75,0.0258719312349
239,2017-11-15,6634.76,7342.25,6634.76,7315.54,7315.54,4200880128,BTC,44.0602601979307500000,6936.528667,0.05463991445795030,1,61314552592,6767.31,7315.54,0.0810115097432
240,2017-11-16,7323.24,7967.38,7176.58,7871.69,7871.69,5123809792,BTC,69.0602601979307500000,7010.154000,0.12289829866790373,1,66438362384,7078.50,7871.69,0.1120562266017
241,2017-11-17,7853.57,8004.59,7561.09,7708.99,7708.99,4651670016,BTC,81.8512817061507500000,7052.186667,0.09313470615765821,-1,61786692368,7207.76,7708.99,0.0695403287568
242,2017-11-18,7697.21,7884.99,7463.44,7790.15,7790.15,3667190016,BTC,94.4352825515080000000,7091.012667,0.09859485038767877,1,65453882384,7379.95,7790.15,0.0555830324054
243,2017-11-19,7766.03,8101.91,7694.10,8036.49,8036.49,3149319936,BTC,96.8224727053215000000,7134.782000,0.12638199737567315,1,68603202320,7407.41,8036.49,0.0849257702760
244,2017-11-20,8039.07,8336.86,7949.36,8200.64,8200.64,3488450048,BTC,96.8224727053215000000,7187.664000,0.14093257559062305,1,72091652368,7022.76,8200.64,0.1677232313222
245,2017-11-21,8205.74,8348.66,7762.71,8071.26,8071.26,4277609984,BTC,97.5019848529295000000,7257.564000,0.11211695825210773,-1,67814042384,7144.38,8071.26,0.1297355403828
246,2017-11-22,8077.95,8302.26,8075.47,8253.55,8253.55,3633530112,BTC,98.5628085329495000000,7331.508667,0.12576420145968300,1,71447572496,7459.69,8253.55,0.1064199718755
247,2017-11-23,8232.38,8267.40,8038.77,8038.77,8038.77,4225179904,BTC,96.2317702777877500000,7370.114000,0.09072532663673859,-1,67222392592,7143.58,8038.77,0.1253139182315
248,2017-11-24,8074.02,8374.16,7940.93,8253.69,8253.69,5058610176,BTC,96.2317702777877500000,7444.121333,0.10875275009438109,1,72281002768,6618.14,8253.69,0.2471313692367
249,2017-11-25,8241.71,8790.92,8191.15,8790.92,8790.92,4342060032,BTC,97.6689617448382500000,7588.973333,0.15838066814300664,1,76623062800,6357.60,8790.92,0.3827419151881
250,2017-11-26,8789.04,9522.93,8775.59,9330.55,9330.55,5475579904,BTC,97.6689617448382500000,7787.170000,0.19819523652366649,1,82098642704,5950.07,9330.55,0.5681412151454
251,2017-11-27,9352.72,9818.35,9352.72,9818.35,9818.35,5653320192,BTC,100.0000000000000000000,8045.055333,0.22042044381299969,1,87751962896,6559.49,9818.35,0.4968160634440
252,2017-11-28,9823.43,10125.70,9736.30,10058.80,10058.80,6348819968,BTC,100.0000000000000000000,8278.342667,0.21507412831525400,1,94100782864,6635.75,10058.80,0.5158497532306
253,2017-11-29,10077.40,11517.40,9601.03,9888.61,9888.61,11568799744,BTC,98.4490168631482500000,8495.200000,0.16402321310857896,-1,82531983120,7315.54,9888.61,0.3517265984466
254,2017-11-30,9906.79,10801.00,9202.05,10233.60,10233.60,8310689792,BTC,98.4490168631482500000,8689.737333,0.17766505566710897,1,90842672912,7871.69,10233.60,0.3000511961218
255,2017-12-01,10198.60,11046.70,9694.65,10975.60,10975.60,6783119872,BTC,98.4490168631482500000,8896.664667,0.23367581119599818,1,97625792784,7708.99,10975.60,0.4237403343369
256,2017-12-02,10978.30,11320.20,10905.10,11074.60,11074.60,5138500096,BTC,98.4490168631482500000,9121.038667,0.21418189356745109,1,102764292880,7790.15,11074.60,0.4216157583615
257,2017-12-03,11082.70,11858.70,10862.00,11323.20,11323.20,6608309760,BTC,100.0000000000000000000,9356.575333,0.21018637663973586,1,109372602640,8036.49,11323.20,0.4089733204421
258,2017-12-04,11315.40,11657.20,11081.80,11657.20,11657.20,6132409856,BTC,100.0000000000000000000,9597.956000,0.21455026466051730,1,115505012496,8200.64,11657.20,0.4214988098490
259,2017-12-05,11685.70,12032.00,11604.60,11916.70,11916.70,6895260160,BTC,100.0000000000000000000,9845.693333,0.21034645270319024,1,122400272656,8071.26,11916.70,0.4764361450381
260,2017-12-06,11923.40,14369.10,11923.40,14291.50,14291.50,12656300032,BTC,100.0000000000000000000,10260.376000,0.39288267798373081,1,135056572688,8253.55,14291.50,0.7315579356762
261,2017-12-07,14266.10,17899.70,14057.30,17899.70,17899.70,17950699520,BTC,100.0000000000000000000,10903.452667,0.64165430406962668,1,153007272208,8038.77,17899.70,1.2266714932757
262,2017-12-08,17802.90,18353.40,14336.90,16569.40,16569.40,21135998976,BTC,96.5522013765277500000,11472.161333,0.44431371901453715,-1,131871273232,8253.69,16569.40,1.0075142148542
263,2017-12-09,16523.30,16783.00,13674.90,15178.20,15178.20,13911300096,BTC,89.0827598047695000000,11933.795333,0.27186696071688026,-1,117959973136,8790.92,15178.20,0.7265769680534
264,2017-12-10,15168.40,15850.60,13226.60,15455.40,15455.40,13433299968,BTC,81.9516557862845000000,12378.094000,0.24860903463812765,1,131393273104,9330.55,15455.40,0.6564296852811
265,2017-12-11,15427.40,17513.90,15404.80,16936.80,16936.80,12153900032,BTC,78.9728836751892500000,12885.177333,0.31444058256175185,1,143547173136,9818.35,16936.80,0.7250148955782
266,2017-12-12,16919.80,17781.80,16571.60,17415.40,17415.40,14603799552,BTC,80.9093398970657500000,13391.647333,0.30046734109287494,1,158150972688,10058.80,17415.40,0.7313596055195
267,2017-12-13,17500.00,17653.10,16039.70,16408.20,16408.20,12976900096,BTC,83.7242962489600000000,13814.940667,0.18771411296717081,-1,145174072592,9888.61,16408.20,0.6593029758480
268,2017-12-14,16384.60,17085.80,16185.90,16564.00,16564.00,13777399808,BTC,86.4995348339130000000,14259.966667,0.16157354268800129,1,158951472400,10233.60,16564.00,0.6185897435897
269,2017-12-15,16601.30,18154.10,16601.30,17706.90,17706.90,14309999616,BTC,88.7821875937567500000,14758.186667,0.19980187265102574,1,173261472016,10975.60,17706.90,0.6132967673749
270,2017-12-16,17760.30,19716.70,17515.30,19497.40,19497.40,12740599808,BTC,90.2935299953525000000,15326.306667,0.27215254292027406,1,186002071824,11074.60,19497.40,0.7605511711484
271,2017-12-17,19475.80,20089.00,18974.10,19140.80,19140.80,13314599936,BTC,93.8573886095547500000,15864.053333,0.20655166735879506,-1,172687471888,11323.20,19140.80,0.6904055390702
272,2017-12-18,19106.40,19371.00,18355.90,19114.20,19114.20,14839499776,BTC,96.9913464386890000000,16383.453333,0.16667711083228438,1,187526971664,11657.20,19114.20,0.6396904917133
273,2017-12-19,19118.30,19177.80,17275.40,17776.70,17776.70,16894499840,BTC,92.0128579041252500000,16791.420000,0.05867758652931080,-1,170632471824,11916.70,17776.70,0.4917468762325
274,2017-12-20,17760.30,17934.70,16077.70,16624.60,16624.60,22149699584,BTC,78.2169724664487500000,17105.280000,-0.02810126463875482,-1,148482772240,14291.50,16624.60,0.1632508833922
275,2017-12-21,16642.40,17567.70,15342.70,15802.90,15802.90,16516599808,BTC,57.9234307075985000000,17206.040000,-0.08154926990754409,-1,131966172432,17899.70,15802.90,-0.1171416280720
276,2017-12-22,15898.00,15943.40,11833.00,13831.80,13831.80,22197999616,BTC,34.1453383119962500000,16934.846667,-0.18323441174384741,-1,109768172816,16569.40,13831.80,-0.1652202252345
277,2017-12-23,13948.70,15603.20,13828.80,14699.20,14699.20,13086000128,BTC,18.6474313714912500000,16810.166667,-0.12557678390804024,1,122854172944,15178.20,14699.20,-0.0315584193119
278,2017-12-24,14608.20,14626.00,12747.70,13925.80,13925.80,11572299776,BTC,7.8581007685012500000,16726.673333,-0.16744951475044150,-1,111281873168,15455.40,13925.80,-0.0989686452631
279,2017-12-25,13995.90,14593.00,13448.90,14026.60,14026.60,10664699904,BTC,5.1018426998022500000,16631.420000,-0.15662042086604752,1,121946573072,16936.80,14026.60,-0.1718270275377
280,2017-12-26,14036.60,16461.20,14028.90,16099.80,16099.80,13454300160,BTC,15.1096088675515000000,16575.620000,-0.02870601521994351,1,135400873232,17415.40,16099.80,-0.0755423360933
281,2017-12-27,16163.50,16930.90,15114.30,15838.50,15838.50,12487600128,BTC,20.1368787065800000000,16470.493333,-0.03837124488152088,-1,122913273104,16408.20,15838.50,-0.0347204446557
282,2017-12-28,15864.10,15888.40,13937.30,14606.50,14606.50,12336499712,BTC,23.1405323354985000000,16350.380000,-0.10665684834236269,-1,110576773392,16564.00,14606.50,-0.1181779763342
283,2017-12-29,14695.80,15279.00,14307.00,14656.20,14656.20,13025500160,BTC,25.9187023439707500000,16223.193333,-0.09658969728311996,-1,97551273232,17706.90,14656.20,-0.1722887687850
284,2017-12-30,14681.90,14681.90,12350.10,12952.20,12952.20,14452599808,BTC,15.9109361762215000000,15906.213333,-0.18571442939668261,-1,83098673424,19497.40,12952.20,-0.3356960415235
285,2017-12-31,12897.70,14377.40,12755.60,14156.40,14156.40,12136299520,BTC,11.9207708930160000000,15550.146667,-0.08962916536072052,1,95234972944,19140.80,14156.40,-0.2604070885229
286,2018-01-01,14112.20,14112.20,13154.70,13657.20,13657.20,10291200000,BTC,11.3626059435177500000,15184.573333,-0.10058717485861939,-1,84943772944,19114.20,13657.20,-0.2854945537872
287,2018-01-02,13625.00,15444.60,13163.60,14982.10,14982.10,16846600192,BTC,18.2435689699770000000,14909.100000,0.00489633847784239,1,101790373136,17776.70,14982.10,-0.1572057806004
288,2018-01-03,14978.20,15572.80,14844.50,15201.00,15201.00,16871900160,BTC,33.5523588621455000000,14737.386667,0.03145831370755334,1,118662273296,16624.60,15201.00,-0.0856321355100
289,2018-01-04,15270.70,15739.70,14522.20,15599.20,15599.20,21783199744,BTC,49.7117238918242500000,14669.026667,0.06341070570773133,1,140445473040,15802.90,15599.20,-0.0128900391700
290,2018-01-05,15477.20,17705.20,15202.80,17429.50,17429.50,23840899072,BTC,71.8514512530705000000,14777.466667,0.17946468043283322,1,164286372112,13831.80,17429.50,0.2601035295479
291,2018-01-06,17462.10,17712.40,16764.60,17527.00,17527.00,18314600448,BTC,86.3327446513500000000,15023.813333,0.16661460120126214,1,182600972560,14699.20,17527.00,0.1923778164798
292,2018-01-07,17527.30,17579.60,16087.70,16477.60,16477.60,15866000384,BTC,90.2892778334142500000,15142.373333,0.08817816320048857,-1,166734972176,13925.80,16477.60,0.1832426144279
293,2018-01-08,16476.20,16537.90,14208.20,15170.10,15170.10,18413899776,BTC,81.3855250502755000000,15225.326667,-0.00362728946366061,-1,148321072400,14026.60,15170.10,0.0815236764433
294,2018-01-09,15123.70,15497.50,14424.00,14595.40,14595.40,16659999744,BTC,65.3651525749760000000,15263.246667,-0.04375521680088694,-1,131661072656,16099.80,14595.40,-0.0934421545609
295,2018-01-10,14588.50,14973.30,13691.20,14973.30,14973.30,18500800512,BTC,51.4098977004460000000,15188.146667,-0.01414568029335715,1,150161873168,15838.50,14973.30,-0.0546263850743
296,2018-01-11,14968.20,15018.80,13105.90,13405.80,13405.80,16534099968,BTC,34.6233715135087500000,15025.966667,-0.10782445501880468,-1,133627773200,14606.50,13405.80,-0.0822031287441
297,2018-01-12,13453.90,14229.90,13158.10,13980.60,13980.60,12065699840,BTC,28.1230873480807500000,14984.240000,-0.06697970667848353,1,145693473040,14656.20,13980.60,-0.0460965325255
298,2018-01-13,13952.40,14659.50,13952.40,14360.20,14360.20,12763599872,BTC,26.8377852583720000000,14964.506667,-0.04038266549291785,1,158457072912,12952.20,14360.20,0.1087074010593
299,2018-01-14,14370.80,14511.80,13268.00,13772.00,13772.00,11084099584,BTC,18.0144804900795000000,15019.160000,-0.08303793288040077,-1,147372973328,14156.40,13772.00,-0.0271537961629
300,2018-01-15,13767.30,14445.50,13641.70,13819.80,13819.80,12750799872,BTC,18.0470880480912500000,14996.720000,-0.07847849396401346,1,160123773200,13657.20,13819.80,0.0119058079255
301,2018-01-16,13836.10,13843.10,10194.90,11490.50,11490.50,18853799936,BTC,12.4271702374765000000,14852.273333,-0.22634739191949397,-1,141269973264,14982.10,11490.50,-0.2330514413867
302,2018-01-17,11431.10,11678.00,9402.29,11188.60,11188.60,18830600192,BTC,4.7328448024847500000,14599.373333,-0.23362463957890486,-1,122439373072,15201.00,11188.60,-0.2639563186632
303,2018-01-18,11198.80,12107.30,10942.50,11474.90,11474.90,15020399616,BTC,3.6406326416975000000,14350.966667,-0.20040926397059410,1,137459772688,15599.20,11474.90,-0.2643917636802
304,2018-01-19,11429.80,11992.80,11172.10,11607.40,11607.40,10740400128,BTC,2.7810646219865000000,14084.846667,-0.17589447195080352,1,148200172816,17429.50,11607.40,-0.3340371209731
305,2018-01-20,11656.20,13103.00,11656.20,12899.20,12899.20,11801700352,BTC,9.5280354663637500000,13782.826667,-0.06411070010157300,1,160001873168,17527.00,12899.20,-0.2640383408456
306,2018-01-21,12889.20,12895.90,11288.20,11600.10,11600.10,9935179776,BTC,11.4731101496687500000,13387.700000,-0.13352554957162171,-1,150066693392,16477.60,11600.10,-0.2960079137739
307,2018-01-22,11633.10,11966.40,10240.20,10931.40,10931.40,10537400320,BTC,10.3438819532785000000,13017.953333,-0.16028274795782754,-1,139529293072,15170.10,10931.40,-0.2794114738861
308,2018-01-23,10944.50,11377.60,10129.70,10868.40,10868.40,9660609536,BTC,8.6920455276822500000,12731.173333,-0.14631591953677786,-1,129868683536,14595.40,10868.40,-0.2553544267372
309,2018-01-24,10903.40,11501.40,10639.80,11359.40,11359.40,9940989952,BTC,4.9354033149402500000,12515.440000,-0.09236910568066324,1,139809673488,14973.30,11359.40,-0.2413562808466
310,2018-01-25,11421.70,11785.70,11057.40,11259.40,11259.40,8873169920,BTC,5.7897444057345000000,12267.846667,-0.08220241859662950,-1,130936503568,13405.80,11259.40,-0.1601098032195
311,2018-01-26,11256.00,11656.70,10470.30,11171.40,11171.40,9746199552,BTC,7.9591126398830000000,12118.886667,-0.07818264936663097,-1,121190304016,13980.60,11171.40,-0.2009355821639
312,2018-01-27,11174.90,11614.90,10989.20,11440.70,11440.70,7583269888,BTC,12.0565695389035000000,11949.560000,-0.04258399472449195,1,128773573904,14360.20,11440.70,-0.2033049678974
313,2018-01-28,11475.30,12040.30,11475.30,11786.30,11786.30,8350360064,BTC,16.8413645773910000000,11777.966667,0.00070753579421724,1,137123933968,13772.00,11786.30,-0.1441838512925
314,2018-01-29,11755.50,11875.60,11179.20,11296.40,11296.40,7107359744,BTC,17.6673469194400000000,11612.926667,-0.02725640797332006,-1,130016574224,13819.80,11296.40,-0.1825930910722
315,2018-01-30,11306.80,11307.20,10036.20,10106.30,10106.30,8637859840,BTC,15.4979786852915000000,11365.360000,-0.11078047681727636,-1,121378714384,11490.50,10106.30,-0.1204647317349
316,2018-01-31,10108.20,10381.60,9777.42,10221.10,10221.10,8041160192,BTC,12.4281275007612500000,11280.733333,-0.09393301851221058,1,129419874576,11188.60,10221.10,-0.0864719446580
317,2018-02-01,10237.30,10288.80,8812.28,9170.54,9170.54,9959400448,BTC,4.6530038306385000000,11146.196000,-0.17724935036132507,-1,119460474128,11474.90,9170.54,-0.2008174363175
318,2018-02-02,9142.28,9142.28,7796.49,8830.75,8830.75,12726899712,BTC,1.0276057144902500000,10969.919333,-0.19500319629196311,-1,106733574416,11607.40,8830.75,-0.2392137774179
319,2018-02-03,8852.12,9430.75,8251.63,9174.91,9174.91,7263790080,BTC,3.1424160230845000000,10807.753333,-0.15108073645744076,1,113997364496,12899.20,9174.91,-0.2887225564376
320,2018-02-04,9175.70,9334.87,8031.22,8277.01,8277.01,7073549824,BTC,2.1148103085942500000,10499.607333,-0.21168385278699260,-1,106923814672,11600.10,8277.01,-0.2864708062862
321,2018-02-05,8270.54,8364.84,6756.68,6955.27,6955.27,9285289984,BTC,2.1148103085942500000,10189.952000,-0.31743839421422201,-1,97638524688,10931.40,6955.27,-0.3637347457782
322,2018-02-06,7051.75,7850.70,6048.26,7754.00,7754.00,13999800320,BTC,6.2481421239627500000,9978.125333,-0.22290011988968469,1,111638325008,10868.40,7754.00,-0.2865555187516
323,2018-02-07,7755.49,8509.11,7236.79,7621.30,7621.30,9169280000,BTC,7.5799570691962500000,9761.652000,-0.21926124799367976,-1,102469045008,11359.40,7621.30,-0.3290754793387
324,2018-02-08,7637.86,8558.77,7637.86,8265.59,8265.59,9346750464,BTC,14.3607056880207500000,9555.398000,-0.13498213261237261,1,111815795472,11259.40,8265.59,-0.2658942750058
325,2018-02-09,8271.84,8736.98,7884.71,8736.98,8736.98,6784820224,BTC,23.5808409386815000000,9387.236667,-0.06927029647456528,1,118600615696,11171.40,8736.98,-0.2179153910880
326,2018-02-10,8720.08,9122.55,8295.47,8621.90,8621.90,7780960256,BTC,28.0721191961132500000,9217.270000,-0.06459287836854079,-1,110819655440,11440.70,8621.90,-0.2463835254836
327,2018-02-11,8616.13,8616.13,7931.10,8129.97,8129.97,6122189824,BTC,30.7044253502875000000,8996.554667,-0.09632405949565270,-1,104697465616,11786.30,8129.97,-0.3102186436795
328,2018-02-12,8141.43,8985.92,8141.43,8926.57,8926.57,6256439808,BTC,35.2761356534487500000,8805.906000,0.01370262185401479,1,110953905424,11296.40,8926.57,-0.2097863036011
329,2018-02-13,8926.72,8958.47,8455.41,8598.31,8598.31,5696719872,BTC,38.6335074989932500000,8626.033333,-0.00321391442969978,-1,105257185552,10106.30,8598.31,-0.1492128672214
330,2018-02-14,8599.92,9518.54,8599.92,9494.63,9494.63,7909819904,BTC,49.4477537046887500000,8585.255333,0.10592284465955790,1,113167005456,10221.10,9494.63,-0.0710755202473
331,2018-02-15,9488.32,10234.80,9395.58,10166.40,10166.40,9062540288,BTC,68.3688222966867500000,8581.608667,0.18467299016957143,1,122229545744,9170.54,10166.40,0.1085933870852
332,2018-02-16,10135.70,10324.10,9824.82,10233.90,10233.90,7296159744,BTC,82.0163633747010000000,8652.499333,0.18276807730786565,1,129525705488,8830.75,10233.90,0.1588936387057
333,2018-02-17,10207.50,11139.50,10149.40,11112.70,11112.70,8660880384,BTC,94.4388562784957500000,8804.629333,0.26214285459460352,1,138186585872,9174.91,11112.70,0.2112053415238
334,2018-02-18,11123.40,11349.80,10326.00,10551.80,10551.80,8744009728,BTC,96.6271230062802500000,8896.422000,0.18607233334929481,-1,129442576144,8277.01,10551.80,0.2748323367979
335,2018-02-19,10552.60,11273.80,10513.20,11225.30,11225.30,7652089856,BTC,96.6271230062802500000,9092.974667,0.23450250452567328,1,137094666000,6955.27,11225.30,0.6139272810401
336,2018-02-20,11231.80,11958.50,11231.80,11403.70,11403.70,9926540288,BTC,96.6271230062802500000,9389.536667,0.21451147212395246,1,147021206288,7754.00,11403.70,0.4706860974981
337,2018-02-21,11372.20,11418.50,10479.10,10690.40,10690.40,9405339648,BTC,91.9125238100027500000,9585.296667,0.11529151067432476,-1,137615866640,7621.30,10690.40,0.4027003267159
338,2018-02-22,10660.40,11039.10,9939.09,10005.00,10005.00,8040079872,BTC,84.6041595284800000000,9744.210000,0.02676358576015911,-1,129575786768,8265.59,10005.00,0.2104399081009
339,2018-02-23,9937.07,10487.30,9734.56,10301.10,10301.10,7739500032,BTC,76.1841004521360000000,9879.910667,0.04263088475150076,1,137315286800,8736.98,10301.10,0.1790229575895
340,2018-02-24,10287.70,10597.20,9546.97,9813.07,9813.07,6917929984,BTC,64.0371763013967500000,9951.650000,-0.01392532896554843,-1,130397356816,8621.90,9813.07,0.1381563228523
341,2018-02-25,9796.42,9923.22,9407.06,9664.73,9664.73,5706939904,BTC,55.4720456482365000000,10021.172000,-0.03556889353860008,-1,124690416912,8129.97,9664.73,0.1887780643717
342,2018-02-26,9669.43,10475.00,9501.73,10366.70,10366.70,7287690240,BTC,56.9121475453532500000,10170.287333,0.01931240097442388,1,131978107152,8926.57,10366.70,0.1613307238951
343,2018-02-27,10393.90,10878.50,10246.10,10725.60,10725.60,6966179840,BTC,59.2893747872642500000,10290.222667,0.04230980680293961,1,138944286992,8598.31,10725.60,0.2474079208589
344,2018-02-28,10687.20,11089.80,10393.10,10397.90,10397.90,6936189952,BTC,58.2649642043372500000,10410.195333,-0.00118108571517618,-1,132008097040,9494.63,10397.90,0.0951348288454
345,2018-03-01,10385.00,11052.30,10352.70,10951.00,10951.00,7317279744,BTC,65.0365311757495000000,10507.286667,0.04222910700567070,1,139325376784,10166.40,10951.00,0.0771757947749
346,2018-03-02,10977.40,11189.00,10850.10,11086.40,11086.40,7620590080,BTC,69.7160622455087500000,10568.620000,0.04899220522641556,1,146945966864,10233.90,11086.40,0.0833015761342
347,2018-03-03,11101.90,11528.20,11002.40,11489.70,11489.70,6690570240,BTC,75.7588940799417500000,10652.340000,0.07860808047809214,1,153636537104,11112.70,11489.70,0.0339251487037
348,2018-03-04,11497.40,11512.60,11136.10,11512.60,11512.60,6084149760,BTC,88.9302288136080000000,10679.000000,0.07805974342166870,1,159720686864,10551.80,11512.60,0.0910555545025
349,2018-03-05,11532.40,11704.10,11443.90,11573.30,11573.30,6468539904,BTC,95.4383916916335000000,10747.100000,0.07687655274446130,1,166189226768,11225.30,11573.30,0.0310013986263
350,2018-03-06,11500.10,11500.10,10694.30,10779.90,10779.90,6832169984,BTC,89.6074024007502500000,10717.406667,0.00583101257064579,-1,159357056784,11403.70,10779.90,-0.0547015442356
351,2018-03-07,10803.90,10929.50,9692.12,9965.57,9965.57,8797910016,BTC,68.5480490629110000000,10621.531333,-0.06175769881335245,-1,150559146768,10690.40,9965.57,-0.0678019531542
352,2018-03-08,9951.44,10147.40,9335.87,9395.01,9395.01,7186089984,BTC,43.5480490629110000000,10535.172000,-0.10822433653669821,-1,143373056784,10005.00,9395.01,-0.0609685157421
353,2018-03-09,9414.69,9466.35,8513.03,9337.55,9337.55,8704190464,BTC,18.5480490629110000000,10490.675333,-0.10991907540715425,-1,134668866320,10301.10,9337.55,-0.0935385541350
354,2018-03-10,9350.59,9531.32,8828.47,8866.00,8866.00,5386319872,BTC,3.9406466621607500000,10395.002000,-0.14709011118997380,-1,129282546448,9813.07,8866.00,-0.0965110816493
355,2018-03-11,8852.78,9711.89,8607.12,9578.63,9578.63,6296370176,BTC,6.5806338418350000000,10379.372667,-0.07714750136545993,1,135578916624,9664.73,9578.63,-0.0089086813600
356,2018-03-12,9602.93,9937.50,8956.43,9205.12,9205.12,6457399808,BTC,9.7121671037565000000,10348.732000,-0.11050745154092308,-1,129121516816,10366.70,9205.12,-0.1120491573982
357,2018-03-13,9173.04,9470.38,8958.19,9194.85,9194.85,5991139840,BTC,12.7488641820262500000,10270.608667,-0.10474147169646027,1,135112656656,10725.60,9194.85,-0.1427192884314
358,2018-03-14,9214.65,9355.85,8068.59,8269.81,8269.81,6438230016,BTC,12.7488641820262500000,10106.889333,-0.18176505871116577,-1,128674426640,10397.90,8269.81,-0.2046653651218
359,2018-03-15,8290.76,8428.35,7783.05,8300.86,8300.86,6834429952,BTC,6.4032091050732500000,9967.086667,-0.16717288839442977,1,135508856592,10951.00,8300.86,-0.2419998173683
360,2018-03-16,8322.91,8585.15,8005.31,8338.35,8338.35,5289379840,BTC,3.7903697093357500000,9792.910000,-0.14853194811348210,1,140798236432,11086.40,8338.35,-0.2478757757252
361,2018-03-17,8321.91,8346.53,7812.82,7916.88,7916.88,4426149888,BTC,0.7536726310660000000,9581.608667,-0.17374208495213218,-1,136372086544,11489.70,7916.88,-0.3109585106661
362,2018-03-18,7890.52,8245.51,7397.99,8223.68,8223.68,6639190016,BTC,2.8513528756767500000,9363.874000,-0.12176520102683996,1,143011276560,11512.60,8223.68,-0.2856800375241
363,2018-03-19,8344.12,8675.87,8182.40,8630.65,8630.65,6729110016,BTC,7.4966258324240000000,9171.744000,-0.05899575914896883,1,149740386576,11573.30,8630.65,-0.2542619650402
364,2018-03-20,8619.67,9051.02,8389.89,8913.47,8913.47,6361789952,BTC,15.6801939134147500000,8994.422000,-0.00900024481839967,1,156102176528,10779.90,8913.47,-0.1731398250448
365,2018-03-21,8937.48,9177.37,8846.33,8929.28,8929.28,6043129856,BTC,28.0344300350340000000,8871.047333,0.00656435083864071,-1,150059046672,9965.57,8929.28,-0.1039870273351
366,2018-03-22,8939.44,9100.71,8564.90,8728.47,8728.47,5530390016,BTC,38.1466189043092500000,8788.574000,-0.00683887966352676,-1,144528656656,9395.01,8728.47,-0.0709461724894
367,2018-03-23,8736.25,8879.62,8360.62,8879.62,8879.62,5954120192,BTC,47.7501944731870000000,8754.214667,0.01432513797870751,1,150482776848,9337.55,8879.62,-0.0490417721993
368,2018-03-24,8901.95,8996.18,8665.70,8668.12,8668.12,5664600064,BTC,50.3498732511515000000,8709.586000,-0.00476096108356930,-1,144818176784,8866.00,8668.12,-0.0223189713512
369,2018-03-25,8612.81,8682.01,8449.10,8495.78,8495.78,4569880064,BTC,46.7048292462767500000,8684.904667,-0.02177625135237423,-1,140248296720,9578.63,8495.78,-0.1130485257286
370,2018-03-26,8498.47,8530.08,7921.43,8209.40,8209.40,5921039872,BTC,40.1716973863185000000,8593.622667,-0.04471020917353480,-1,134327256848,9205.12,8209.40,-0.1081702356949
371,2018-03-27,8200.00,8232.78,7797.28,7833.04,7833.04,5378250240,BTC,25.6878700958115000000,8502.150667,-0.07869898960942514,-1,128949006608,9194.85,7833.04,-0.1481057331006
372,2018-03-28,7836.83,8122.89,7809.17,7954.48,7954.48,4935289856,BTC,17.1553959108460000000,8419.459333,-0.05522674492618753,1,133884296464,8269.81,7954.48,-0.0381302593409
373,2018-03-29,7979.07,7994.33,7081.38,7165.70,7165.70,6361229824,BTC,8.4462037941015000000,8345.852000,-0.14140581452918168,-1,127523066640,8300.86,7165.70,-0.1367520955660
374,2018-03-30,7171.45,7276.66,6683.93,6890.52,6890.52,6289509888,BTC,2.7694665401737500000,8251.829333,-0.16497061173526333,-1,121233556752,8338.35,6890.52,-0.1736350716868
375,2018-03-31,6892.48,7207.85,6863.52,6973.53,6973.53,4553269760,BTC,3.7873646743337500000,8160.841333,-0.14548883926941066,1,125786826512,7916.88,6973.53,-0.1191567890381
376,2018-04-01,7003.06,7060.95,6526.87,6844.23,6844.23,4532100096,BTC,1.0178981341600000000,8089.331333,-0.15391894357456652,-1,121254726416,8223.68,6844.23,-0.1677412058835
377,2018-04-02,6844.86,7135.47,6816.58,7083.80,7083.80,4333440000,BTC,3.8903712163402500000,8013.339333,-0.11599899796730597,1,125588166416,8630.65,7083.80,-0.1792275205228
378,2018-04-03,7102.26,7530.94,7072.49,7456.11,7456.11,5499700224,BTC,11.2268859282177500000,7935.036667,-0.06035594882525828,1,131087866640,8913.47,7456.11,-0.1635008588126
379,2018-04-04,7456.41,7469.88,6803.88,6853.84,6853.84,4936000000,BTC,10.3242128486127500000,7797.728000,-0.12104654073596822,-1,126151866640,8929.28,6853.84,-0.2324308342890
380,2018-04-05,6848.65,6933.82,6644.80,6811.47,6811.47,5639320064,BTC,10.3242128486127500000,7656.540667,-0.11037238666311651,-1,120512546576,8728.47,6811.47,-0.2196261200417
381,2018-04-06,6815.96,6857.49,6575.00,6636.32,6636.32,3766810112,BTC,7.4517397664325000000,7517.064000,-0.11716595734717704,-1,116745736464,8879.62,6636.32,-0.2526346848176
382,2018-04-07,6630.51,7050.54,6630.51,6911.09,6911.09,3976610048,BTC,3.4960942345925000000,7385.828667,-0.06427696720357729,1,120722346512,8668.12,6911.09,-0.2027002394983
383,2018-04-08,6919.98,7111.56,6919.98,7023.52,7023.52,3652499968,BTC,8.5866816202082500000,7276.188667,-0.03472541443928449,1,124374846480,8495.78,7023.52,-0.1732930937477
384,2018-04-09,7044.32,7178.11,6661.99,6770.73,6770.73,4894060032,BTC,10.7227776865240000000,7161.185333,-0.05452384135356939,-1,119480786448,8209.40,6770.73,-0.1752466684532
385,2018-04-10,6795.44,6872.41,6704.15,6834.76,6834.76,4272750080,BTC,14.4863572216335000000,7069.542667,-0.03321044628472853,1,123753536528,7833.04,6834.76,-0.1274447724000
386,2018-04-11,6843.47,6968.32,6817.59,6968.32,6968.32,4641889792,BTC,17.4021439862460000000,7011.894667,-0.00621439269546860,1,128395426320,7954.48,6968.32,-0.1239754201406
387,2018-04-12,6955.38,7899.23,6806.51,7889.25,7889.25,8906250240,BTC,37.1963315460752500000,7007.546000,0.12582207808553808,1,137301676560,7165.70,7889.25,0.1009740848766
388,2018-04-13,7901.09,8183.96,7758.93,7895.96,7895.96,7764460032,BTC,60.0602354797595000000,7056.230000,0.11900547459479070,-1,129537216528,6890.52,7895.96,0.1459164184996
389,2018-04-14,7874.67,8140.71,7846.00,7986.24,7986.24,5191430144,BTC,81.2966559446500000000,7129.278000,0.12020319589164569,1,134728646672,6973.53,7986.24,0.1452220037771
390,2018-04-15,7999.33,8338.42,7999.33,8329.11,8329.11,5244480000,BTC,100.0000000000000000000,7219.650000,0.15367226943134362,1,139973126672,6844.23,8329.11,0.2169535506551
391,2018-04-16,8337.57,8371.15,7925.73,8058.67,8058.67,5631309824,BTC,96.0060019258147500000,7300.612667,0.10383475573585035,-1,134341816848,7083.80,8058.67,0.1376196391767
392,2018-04-17,8071.66,8285.96,7881.72,7902.09,7902.09,6900879872,BTC,89.6995492648232500000,7355.165333,0.07435926212917939,-1,127440936976,7456.11,7902.09,0.0598140317136
393,2018-04-18,7944.43,8197.80,7886.01,8163.42,8163.42,6529909760,BTC,87.2525534768047500000,7402.319333,0.10281921554058954,1,133970846736,6853.84,8163.42,0.1910724498967
394,2018-04-19,8159.27,8298.69,8138.78,8294.31,8294.31,7063209984,BTC,86.7386090418777500000,7498.350667,0.10615125490236025,1,141034056720,6811.47,8294.31,0.2176975014204
395,2018-04-20,8286.88,8880.23,8244.54,8845.83,8845.83,8438110208,BTC,90.7326071160630000000,7633.974667,0.15874500320764557,1,149472166928,6636.32,8845.83,0.3329420522217
396,2018-04-21,8848.79,8997.57,8652.15,8895.58,8895.58,7548550144,BTC,97.0390597770545000000,7784.592000,0.14271627851530305,1,157020717072,6911.09,8895.58,0.2871457324387
397,2018-04-22,8925.06,9001.64,8779.61,8802.46,8802.46,6629899776,BTC,98.3904488163612500000,7910.683333,0.11273067438812621,-1,150390817296,7023.52,8802.46,0.2532832539809
398,2018-04-23,8794.39,8958.55,8788.81,8930.88,8930.88,6925190144,BTC,98.9043932512882500000,8037.840667,0.11110438362711576,1,157316007440,6770.73,8930.88,0.3190424075395
399,2018-04-24,8934.34,9732.61,8927.83,9697.50,9697.50,10678800384,BTC,98.9043932512882500000,8232.958667,0.17788760908885540,1,167994807824,6834.76,9697.50,0.4188501132446
400,2018-04-25,9701.03,9745.32,8799.84,8845.74,8845.74,11083100160,BTC,91.1020496902185000000,8367.024000,0.05721460820478105,-1,156911707664,6968.32,8845.74,0.2694221849743
401,2018-04-26,8867.32,9281.51,8727.09,9281.51,9281.51,8970559488,BTC,86.4463775781532500000,8521.236667,0.08922100895804165,1,165882267152,7889.25,9281.51,0.1764755838641
402,2018-04-27,9290.63,9375.47,8987.05,8987.05,8987.05,7566289920,BTC,76.5874513261687500000,8594.423333,0.04568388730543813,-1,158315977232,7895.96,8987.05,0.1381833241303
403,2018-04-28,8939.27,9412.09,8931.99,9348.48,9348.48,7805479936,BTC,71.7275585997162500000,8691.258000,0.07561874241910665,1,166121457168,7986.24,9348.48,0.1705733862243
404,2018-04-29,9346.41,9531.49,9193.71,9419.08,9419.08,8853000192,BTC,75.6530717989187500000,8786.780667,0.07196029546688126,1,174974457360,8329.11,9419.08,0.1308627212271
405,2018-04-30,9426.11,9477.14,9166.81,9240.55,9240.55,8673920000,BTC,75.0415978622845000000,8847.543333,0.04441986348166779,-1,166300537360,8058.67,9240.55,0.1466594363586
406,2018-05-01,9251.47,9255.88,8891.05,9119.01,9119.01,7713019904,BTC,76.8454002149925000000,8918.232667,0.02251313017913665,-1,158587517456,7902.09,9119.01,0.1539997646192
407,2018-05-02,9104.60,9256.52,9015.14,9235.92,9235.92,7558159872,BTC,74.1831950065262500000,9007.154667,0.02539817972018843,1,166145677328,8163.42,9235.92,0.1313787603725
408,2018-05-03,9233.97,9798.33,9188.15,9743.86,9743.86,10207299584,BTC,78.0600253683935000000,9112.517333,0.06928301411440509,1,176352976912,8294.31,9743.86,0.1747643866699
409,2018-05-04,9695.50,9779.20,9585.96,9700.76,9700.76,8217829888,BTC,83.2782062516342500000,9206.280667,0.05371108603851997,1,184570806800,8845.83,9700.76,0.0966477990194
410,2018-05-05,9700.28,9964.50,9695.12,9858.15,9858.15,7651939840,BTC,91.3333301509107500000,9273.768667,0.06301443932707492,1,192222746640,8895.58,9858.15,0.1082076716751
411,2018-05-06,9845.31,9940.14,9465.25,9654.80,9654.80,7222280192,BTC,94.0398572269600000000,9324.383333,0.03543576611984835,-1,185000466448,8802.46,9654.80,0.0968297498654
412,2018-05-07,9645.67,9665.85,9231.53,9373.01,9373.01,7394019840,BTC,82.0600269210562500000,9362.420000,0.00113111780928435,-1,177606446608,8930.88,9373.01,0.0495057597907
413,2018-05-08,9380.87,9462.75,9127.77,9234.82,9234.82,7415869952,BTC,67.8123664392607500000,9382.682667,-0.01575910347261881,-1,170190576656,9697.50,9234.82,-0.0477112657902
414,2018-05-09,9223.73,9374.76,9031.62,9325.18,9325.18,7226890240,BTC,54.6514434930235000000,9357.861333,-0.00349239338317090,1,177417466896,8845.74,9325.18,0.0542001008395
415,2018-05-10,9325.96,9396.04,9040.52,9043.94,9043.94,6906699776,BTC,36.0997201262012500000,9371.074667,-0.03490898094665667,-1,170510767120,9281.51,9043.94,-0.0255960506426
416,2018-05-11,9052.96,9052.96,8394.46,8441.49,8441.49,8488520192,BTC,23.0795504321050000000,9315.073333,-0.09378169143394762,-1,162022246928,8987.05,8441.49,-0.0607051257087
417,2018-05-12,8441.44,8664.86,8223.50,8504.89,8504.89,6821380096,BTC,14.5906116225595000000,9282.929333,-0.08381398856868794,1,168843627024,9348.48,8504.89,-0.0902381991511
418,2018-05-13,8515.49,8773.55,8395.12,8723.94,8723.94,5866379776,BTC,7.7359697896685000000,9241.293333,-0.05598278448240228,1,174710006800,9419.08,8723.94,-0.0738012629684
419,2018-05-14,8713.10,8881.12,8367.97,8716.79,8716.79,7364149760,BTC,10.9615221718692500000,9194.474000,-0.05195337982357664,1,182074156560,9240.55,8716.79,-0.0566806088382
420,2018-05-15,8705.19,8836.19,8456.45,8510.38,8510.38,6705710080,BTC,12.1772337752180000000,9145.796000,-0.06947629271416069,-1,175368446480,9119.01,8510.38,-0.0667429907413
421,2018-05-16,8504.41,8508.43,8175.49,8368.83,8368.83,6760220160,BTC,11.0584049807295000000,9095.784000,-0.07992208258243599,-1,168608226320,9235.92,8368.83,-0.0938823636411
422,2018-05-17,8370.05,8445.54,8054.12,8094.32,8094.32,5862530048,BTC,6.0739697598577500000,9019.677333,-0.10259317477072325,-1,162745696272,9743.86,8094.32,-0.1692901991613
423,2018-05-18,8091.83,8274.12,7974.82,8250.97,8250.97,5764190208,BTC,3.4360219507177500000,8920.151333,-0.07501905606963989,1,168509886480,9700.76,8250.97,-0.1494511770212
424,2018-05-19,8255.73,8372.06,8183.35,8247.18,8247.18,4712399872,BTC,4.3869023658742500000,8823.246000,-0.06528957710121649,-1,163797486608,9858.15,8247.18,-0.1634150423761
425,2018-05-20,8246.99,8562.41,8205.24,8513.25,8513.25,5191059968,BTC,11.0984590663767500000,8733.586000,-0.02522858308145131,1,168988546576,9654.80,8513.25,-0.1182365248374
426,2018-05-21,8522.33,8557.52,8365.12,8418.99,8418.99,5154990080,BTC,17.4461664856887500000,8651.198667,-0.02684121310099605,-1,163833556496,9373.01,8418.99,-0.1017837386283
427,2018-05-22,8419.87,8423.25,8004.58,8041.78,8041.78,5137010176,BTC,15.2258561383197500000,8562.450000,-0.06080853026878989,-1,158696546320,9234.82,8041.78,-0.1291893074256
428,2018-05-23,8037.08,8054.66,7507.88,7557.82,7557.82,6491120128,BTC,13.0592641198145000000,8450.650000,-0.10565222793512925,-1,152205426192,9325.18,7557.82,-0.1895255641178
429,2018-05-24,7561.12,7738.60,7331.14,7587.34,7587.34,6049220096,BTC,6.8443025798642500000,8334.794000,-0.08967876110675321,1,158254646288,9043.94,7587.34,-0.1610581228978
430,2018-05-25,7592.30,7659.14,7392.65,7480.14,7480.14,4867829760,BTC,0.4965951605522500000,8230.540667,-0.09117270630940435,-1,153386816528,8441.49,7480.14,-0.1138839233358
431,2018-05-26,7486.48,7595.16,7349.12,7355.88,7355.88,4051539968,BTC,0.4965951605522500000,8158.166667,-0.09834153918983671,-1,149335276560,8504.89,7355.88,-0.1350999248668
432,2018-05-27,7362.08,7381.74,7270.96,7368.22,7368.22,4056519936,BTC,0.7220969660285000000,8082.388667,-0.08836108932943499,1,153391796496,8723.94,7368.22,-0.1554022609050
433,2018-05-28,7371.31,7419.05,7100.89,7135.99,7135.99,5040600064,BTC,0.2255018054762500000,7976.525333,-0.10537612530641480,-1,148351196432,8716.79,7135.99,-0.1813511625266
434,2018-05-29,7129.46,7526.42,7090.68,7472.59,7472.59,5662660096,BTC,6.3354592572282500000,7893.578667,-0.05333305522880146,1,154013856528,8510.38,7472.59,-0.1219440260012
435,2018-05-30,7469.73,7573.77,7313.60,7406.52,7406.52,4922540032,BTC,11.2461151972832500000,7819.988000,-0.05287322691543772,-1,149091316496,8368.83,7406.52,-0.1149873996724
436,2018-05-31,7406.15,7608.90,7361.13,7494.17,7494.17,5127130112,BTC,17.5222906350290000000,7761.677333,-0.03446514477774671,1,154218446608,8094.32,7494.17,-0.0741445853389
437,2018-06-01,7500.70,7604.73,7407.34,7541.45,7541.45,4921460224,BTC,24.8821936308322500000,7724.819333,-0.02373768564614274,1,159139906832,8250.97,7541.45,-0.0859923136310
438,2018-06-02,7536.72,7695.83,7497.26,7643.45,7643.45,4939299840,BTC,27.9836414329902500000,7684.318000,-0.00531836397192308,1,164079206672,8247.18,7643.45,-0.0732044165400
439,2018-06-03,7632.09,7754.89,7613.04,7720.25,7720.25,4851760128,BTC,33.6784630353020000000,7649.189333,0.00928996053129857,1,168930966800,8513.25,7720.25,-0.0931489149267
440,2018-06-04,7722.53,7753.82,7474.04,7514.47,7514.47,4993169920,BTC,34.5516883641767500000,7582.604000,-0.00898556749106244,-1,163937796880,8418.99,7514.47,-0.1074380656112
441,2018-06-05,7500.90,7643.23,7397.00,7633.76,7633.76,4961739776,BTC,40.9303450786817500000,7530.255333,0.01374517362597378,1,168899536656,8041.78,7633.76,-0.0507375232846
442,2018-06-06,7625.97,7680.43,7502.01,7653.98,7653.98,4692259840,BTC,53.8833015815240000000,7504.402000,0.01993203455785018,1,173591796496,7557.82,7653.98,0.0127232455920
443,2018-06-07,7650.82,7741.27,7650.82,7678.24,7678.24,4485799936,BTC,66.4802510408345000000,7512.430000,0.02207142029942376,1,178077596432,7587.34,7678.24,0.0119804832787
444,2018-06-08,7685.14,7698.19,7558.40,7624.92,7624.92,4227579904,BTC,80.0262569683782500000,7514.935333,0.01463547750265119,-1,173850016528,7480.14,7624.92,0.0193552527092
445,2018-06-09,7632.52,7683.58,7531.98,7531.98,7531.98,3845220096,BTC,83.2317803717522500000,7518.391333,0.00180739022460245,-1,170004796432,7355.88,7531.98,0.0239400316482
446,2018-06-10,7499.55,7499.55,6709.07,6786.02,6786.02,5804839936,BTC,61.0674186150000000000,7480.400667,-0.09282666770287854,-1,164199956496,7368.22,6786.02,-0.0790150131239
447,2018-06-11,6799.29,6910.18,6706.63,6906.92,6906.92,4745269760,BTC,41.1002762862620000000,7449.647333,-0.07285275513591886,1,168945226256,7135.99,6906.92,-0.0321006615760
448,2018-06-12,6905.82,6907.96,6542.08,6582.36,6582.36,4654380032,BTC,20.1793677866215000000,7412.738667,-0.11202049664811150,-1,164290846224,7472.59,6582.36,-0.1191327237276
449,2018-06-13,6596.88,6631.66,6285.63,6349.90,6349.90,5052349952,BTC,3.2352846729392500000,7337.892667,-0.13464256181385761,-1,159238496272,7406.52,6349.90,-0.1426607907627
450,2018-06-14,6342.75,6707.14,6334.46,6675.35,6675.35,5138710016,BTC,9.1726364443845000000,7289.148000,-0.08420709800377218,1,164377206288,7494.17,6675.35,-0.1092609321646
451,2018-06-15,6674.08,6681.08,6433.87,6456.58,6456.58,3955389952,BTC,7.8835698909037500000,7219.975333,-0.10573378686084771,-1,160421816336,7541.45,6456.58,-0.1438542985765
452,2018-06-16,6455.45,6592.49,6402.29,6550.16,6550.16,3194170112,BTC,11.5370160907797500000,7153.889333,-0.08439176298339867,1,163615986448,7643.45,6550.16,-0.1430361943887
453,2018-06-17,6545.53,6589.11,6499.27,6499.27,6499.27,3104019968,BTC,14.2620498412815000000,7077.610667,-0.08171411147219014,-1,160511966480,7720.25,6499.27,-0.1581529095560
454,2018-06-18,6510.07,6781.14,6446.68,6734.82,6734.82,4039200000,BTC,15.5690782736997500000,7011.915333,-0.03951778078322099,1,164551166480,7514.47,6734.82,-0.1037531589054
455,2018-06-19,6742.39,6822.50,6709.92,6769.94,6769.94,4057029888,BTC,21.5282157108005000000,6962.280000,-0.02762600757223208,1,168608196368,7633.76,6769.94,-0.1131578671585
456,2018-06-20,6770.76,6821.56,6611.88,6776.55,6776.55,3888640000,BTC,25.9045284581820000000,6905.132667,-0.01862131738822390,1,172496836368,7653.98,6776.55,-0.1146370907685
457,2018-06-21,6780.09,6810.94,6715.17,6729.74,6729.74,3529129984,BTC,30.3282668593885000000,6843.516667,-0.01662546794817355,-1,168967706384,7678.24,6729.74,-0.1235309133343
458,2018-06-22,6737.88,6747.08,6006.60,6083.69,6083.69,5079810048,BTC,23.0838866555250000000,6737.213333,-0.09700202453126030,-1,163887896336,7624.92,6083.69,-0.2021306453051
459,2018-06-23,6090.10,6224.82,6071.81,6162.48,6162.48,3431360000,BTC,16.5385832984562500000,6639.717333,-0.07187615211088686,1,167319256336,7531.98,6162.48,-0.1818246994814
460,2018-06-24,6164.28,6223.78,5826.41,6173.23,6173.23,4566909952,BTC,11.2279915341245000000,6549.134000,-0.05739751240393005,1,171886166288,6786.02,6173.23,-0.0903018264019
461,2018-06-25,6171.97,6327.37,6119.68,6249.18,6249.18,5500810240,BTC,9.1048501295950000000,6513.344667,-0.04055745250798655,1,177386976528,6906.92,6249.18,-0.0952291325222
462,2018-06-26,6253.55,6290.16,6093.67,6093.67,6093.67,3279759872,BTC,9.4649517374235000000,6459.128000,-0.05658008325582029,-1,174107216656,6582.36,6093.67,-0.0742423689984
463,2018-06-27,6084.40,6180.00,6052.85,6157.13,6157.13,3296219904,BTC,10.7547855177847500000,6430.779333,-0.04255305909747969,1,177403436560,6349.90,6157.13,-0.0303579583930
464,2018-06-28,6153.16,6170.41,5873.05,5903.44,5903.44,3467800064,BTC,8.0356183348590000000,6401.015333,-0.07773381363965559,-1,173935636496,6675.35,5903.44,-0.1156358842608
465,2018-06-29,5898.13,6261.66,5835.75,6218.30,6218.30,3966230016,BTC,12.0254610102730000000,6370.545333,-0.02389832032296441,1,177901866512,6456.58,6218.30,-0.0369049868506
466,2018-06-30,6214.22,6465.51,6214.22,6404.00,6404.00,4543860224,BTC,25.9980322615345000000,6367.040000,0.00580489521033322,1,182445726736,6550.16,6404.00,-0.0223139587430
467,2018-07-01,6411.68,6432.85,6289.29,6385.82,6385.82,4788259840,BTC,37.1602661749380000000,6356.084000,0.00467835226847222,-1,177657466896,6499.27,6385.82,-0.0174558065752
468,2018-07-02,6380.38,6683.86,6305.70,6614.18,6614.18,4396930048,BTC,57.5110810779857500000,6363.744667,0.03935345399677394,1,182054396944,6734.82,6614.18,-0.0179128766619
469,2018-07-03,6596.66,6671.37,6447.75,6529.59,6529.59,4672309760,BTC,66.4243337036572500000,6350.062667,0.02827174193618080,-1,177382087184,6769.94,6529.59,-0.0355025303031
470,2018-07-04,6550.87,6771.92,6450.46,6597.55,6597.55,4176689920,BTC,71.9663043602755000000,6338.570000,0.04085779600130629,1,181558777104,6776.55,6597.55,-0.0264146210092
471,2018-07-05,6599.71,6749.54,6546.65,6639.14,6639.14,4999240192,BTC,80.4130492860932500000,6329.409333,0.04893516135623267,1,186558017296,6729.74,6639.14,-0.0134626300570
472,2018-07-06,6638.69,6700.94,6533.55,6673.50,6673.50,4313959936,BTC,85.0622343830455000000,6325.660000,0.05498872844888913,1,190871977232,6083.69,6673.50,0.0969493843375
473,2018-07-07,6668.71,6863.99,6579.24,6856.93,6856.93,3961080064,BTC,92.1335083347812500000,6377.209333,0.07522423084304296,1,194833057296,6162.48,6856.93,0.1126900209007
474,2018-07-08,6857.80,6885.91,6747.98,6773.88,6773.88,3386210048,BTC,95.0813380489967500000,6417.969333,0.05545533930334846,-1,191446847248,6173.23,6773.88,0.0972991448561
475,2018-07-09,6775.08,6838.68,6724.34,6741.75,6741.75,3718129920,BTC,94.8025149713160000000,6455.870667,0.04428207251135132,-1,187728717328,6249.18,6741.75,0.0788215413862
476,2018-07-10,6739.21,6767.74,6320.72,6329.95,6329.95,4052430080,BTC,80.9853800249610000000,6461.255333,-0.02032195389793304,-1,183676287248,6093.67,6329.95,0.0387746628879
477,2018-07-11,6330.77,6444.96,6330.47,6394.71,6394.71,3644859904,BTC,68.8662177893842500000,6481.324667,-0.01336372909090684,1,187321147152,6157.13,6394.71,0.0385861594607
478,2018-07-12,6396.78,6397.10,6136.42,6228.81,6228.81,3770170112,BTC,54.5747726772172500000,6486.103333,-0.03966839869647818,-1,183550977040,5903.44,6228.81,0.0551153225916
479,2018-07-13,6235.03,6310.55,6192.24,6238.05,6238.05,3805400064,BTC,33.3678703123027500000,6508.410667,-0.04154019788130865,1,187356377104,6218.30,6238.05,0.0031761092260
480,2018-07-14,6247.50,6298.19,6212.22,6276.12,6276.12,2923670016,BTC,24.0680053223397500000,6512.265333,-0.03626162647325906,1,190280047120,6404.00,6276.12,-0.0199687695191
481,2018-07-15,6272.70,6403.46,6256.51,6359.64,6359.64,3285459968,BTC,16.3943731874140000000,6509.308000,-0.02299292029198803,1,193565507088,6385.82,6359.64,-0.0040997084165
482,2018-07-16,6357.01,6741.75,6357.01,6741.75,6741.75,4725799936,BTC,28.2790299706315000000,6533.036667,0.03194736898604338,1,198291307024,6614.18,6741.75,0.0192873493010
483,2018-07-17,6739.65,7387.24,6684.17,7321.04,7321.04,5961950208,BTC,52.5058905941537500000,6580.160667,0.11259289407864545,1,204253257232,6529.59,7321.04,0.1212097543644
484,2018-07-18,7315.32,7534.99,7280.47,7370.78,7370.78,6103410176,BTC,75.6228905304717500000,6636.240000,0.11068617168758212,1,210356667408,6597.55,7370.78,0.1171995665057
485,2018-07-19,7378.20,7494.46,7295.46,7466.86,7466.86,5111629824,BTC,95.4156849009742500000,6694.194000,0.11542330562872842,1,215468297232,6639.14,7466.86,0.1246727738834
486,2018-07-20,7467.40,7594.67,7323.26,7354.13,7354.13,4936869888,BTC,97.7236379790800000000,6741.860000,0.09081618425775676,-1,210531427344,6673.50,7354.13,0.1019899602907
487,2018-07-21,7352.72,7437.64,7262.41,7419.29,7419.29,3726609920,BTC,96.7630548039255000000,6791.579333,0.09242484497677589,1,214258037264,6856.93,7419.29,0.0820133791653
488,2018-07-22,7417.80,7537.95,7383.82,7418.49,7418.49,3695460096,BTC,95.7863171923590000000,6829.016667,0.08631891848331903,1,217953497360,6773.88,7418.49,0.0951611188861
489,2018-07-23,7414.71,7771.50,7409.10,7711.11,7711.11,5132480000,BTC,95.7863171923590000000,6891.498667,0.11893078307113601,1,223085977360,6741.75,7711.11,0.1437846256536
490,2018-07-24,7716.51,8424.27,7705.50,8424.27,8424.27,7277689856,BTC,98.0626792132790000000,7003.666667,0.20283708527900447,1,230363667216,6329.95,8424.27,0.3308588535454
491,2018-07-25,8379.66,8416.87,8086.36,8181.39,8181.39,5845400064,BTC,96.2575549740420000000,7127.096000,0.14792757106120080,-1,224518267152,6394.71,8181.39,0.2793996913073
492,2018-07-26,8176.85,8290.33,7878.71,7951.58,7951.58,4899089920,BTC,91.8517076148050000000,7230.887333,0.09966863454101063,-1,219619177232,6228.81,7951.58,0.2765809199510
493,2018-07-27,7950.40,8262.66,7839.76,8165.01,8165.01,5195879936,BTC,88.8870014095740000000,7359.967333,0.10938128263021191,1,224815057168,6238.05,8165.01,0.3089042248780
494,2018-07-28,8169.06,8222.85,8110.77,8192.15,8192.15,3988750080,BTC,86.1856071866380000000,7490.240667,0.09370985048483490,1,228803807248,6276.12,8192.15,0.3052889364767
495,2018-07-29,8205.82,8272.26,8141.18,8218.46,8218.46,4107190016,BTC,86.4592215867847500000,7619.730000,0.07857627501236920,1,232910997264,6359.64,8218.46,0.2922838399658
496,2018-07-30,8221.58,8235.50,7917.50,8180.48,8180.48,5551400000,BTC,88.2194127673212500000,7741.119333,0.05675673608686378,-1,227359597264,6741.75,8180.48,0.2134060147588
497,2018-07-31,8181.20,8181.53,7696.93,7780.44,7780.44,5287530000,BTC,76.5944595180415000000,7810.365333,-0.00383148953014539,-1,222072067264,7321.04,7780.44,0.0627506474490
498,2018-08-01,7769.04,7769.04,7504.95,7624.91,7624.91,4797620000,BTC,60.6216615792042500000,7830.623333,-0.02627036498270552,-1,217274447264,7370.78,7624.91,0.0344780335324
499,2018-08-02,7634.19,7712.77,7523.44,7567.15,7567.15,4214110000,BTC,43.0902062726685000000,7843.714667,-0.03525939924402913,-1,213060337264,7466.86,7567.15,0.0134313486526
500,2018-08-03,7562.14,7562.14,7328.65,7434.39,7434.39,4627150000,BTC,23.5875883822207500000,7841.550000,-0.05192340799969394,-1,208433187264,7354.13,7434.39,0.0109135954899
501,2018-08-04,7438.67,7497.49,6984.07,7032.85,7032.85,4268390000,BTC,13.1772478367315000000,7820.131333,-0.10067367151210988,-1,204164797264,7419.29,7032.85,-0.0520858464894
502,2018-08-05,7031.08,7102.77,6940.70,7068.48,7068.48,3679110000,BTC,7.4916133465952500000,7796.744000,-0.09340617057581986,1,207843907264,7418.49,7068.48,-0.0471807605052
503,2018-08-06,7062.94,7166.55,6890.54,6951.80,6951.80,3925900000,BTC,2.5151616673757500000,7765.631333,-0.10479912039367991,-1,203918007264,7711.11,6951.80,-0.0984696107305
504,2018-08-07,6958.32,7146.56,6748.24,6753.12,6753.12,4682800000,BTC,0.6401733480905000000,7701.765333,-0.12317245358480465,-1,199235207264,8424.27,6753.12,-0.1983732715120
505,2018-08-08,6746.85,6746.85,6226.22,6305.80,6305.80,5064430000,BTC,0.6401733480905000000,7560.534000,-0.16595838336286828,-1,194170777264,8181.39,6305.80,-0.2292507752350
506,2018-08-09,6305.56,6625.73,6249.07,6568.23,6568.23,4267040000,BTC,3.4301705478235000000,7452.990000,-0.11871208736359501,1,198437817264,7951.58,6568.23,-0.1739717137978
507,2018-08-10,6571.42,6591.26,6124.52,6184.71,6184.71,4528680000,BTC,3.4301705478235000000,7335.198667,-0.15684492257529199,-1,193909137264,8165.01,6184.71,-0.2425349142255
508,2018-08-11,6185.79,6455.74,6109.03,6295.73,6295.73,4047850000,BTC,4.7948908920152500000,7210.580000,-0.12687606267456987,1,197956987264,8192.15,6295.73,-0.2314923432798
509,2018-08-12,6283.65,6409.85,6237.50,6322.69,6322.69,5665250000,BTC,6.4910187346705000000,7085.949333,-0.10771447792399844,1,203622237264,8218.46,6322.69,-0.2306721697252
510,2018-08-13,6341.36,6537.05,6225.72,6297.57,6297.57,4083980000,BTC,4.4745882470745000000,6957.890000,-0.09490233389720159,-1,199538257264,8180.48,6297.57,-0.2301710902050
511,2018-08-14,6287.66,6287.94,5971.05,6199.71,6199.71,5301700000,BTC,4.7095904090945000000,6825.838667,-0.09172919219832478,-1,194236557264,7780.44,6199.71,-0.2031671730648
512,2018-08-15,6221.42,6588.49,6221.42,6308.52,6308.52,4895450000,BTC,5.4940507342542500000,6727.710667,-0.06230806997336647,1,199132007264,7624.91,6308.52,-0.1726433492330
513,2018-08-16,6294.23,6473.50,6276.41,6334.73,6334.73,4328420000,BTC,6.5108796926175000000,6641.698667,-0.04621839718884073,1,203460427264,7567.15,6334.73,-0.1628644866297
514,2018-08-17,6340.91,6582.50,6324.97,6580.63,6580.63,4992990000,BTC,13.0175672618632500000,6575.930667,0.00071462629975445,1,208453417264,7434.39,6580.63,-0.1148392806942
515,2018-08-18,6583.43,6617.35,6353.73,6423.76,6423.76,3984520000,BTC,19.5447883027127500000,6508.555333,-0.01302828794741384,-1,204468897264,7032.85,6423.76,-0.0866064255601
516,2018-08-19,6422.57,6537.98,6361.55,6506.07,6506.07,3311170000,BTC,26.4862081289652500000,6473.436667,0.00504111412201756,1,207780067264,7068.48,6506.07,-0.0795659038435
517,2018-08-20,6500.51,6536.92,6297.93,6308.53,6308.53,3665100000,BTC,27.8086317917775000000,6422.773333,-0.01778722789624561,-1,204114967264,6951.80,6308.53,-0.0925328691850
518,2018-08-21,6301.07,6500.87,6298.24,6488.76,6488.76,3377180000,BTC,33.2610336339885000000,6391.904000,0.01515291844182891,1,207492147264,6753.12,6488.76,-0.0391463501315
519,2018-08-22,6486.25,6816.79,6310.11,6376.71,6376.71,4668110000,BTC,38.6224717768455000000,6366.810000,0.00155493881551358,-1,202824037264,6305.80,6376.71,0.0112452028291
520,2018-08-23,6371.34,6546.54,6371.34,6534.88,6534.88,3426180000,BTC,51.6430301012052500000,6382.082000,0.02394171682532440,1,206250217264,6568.23,6534.88,-0.0050774714040
521,2018-08-24,6551.52,6719.96,6498.64,6719.96,6719.96,4097820000,BTC,72.6076496373745000000,6392.197333,0.05127543001651573,1,210348037264,6184.71,6719.96,0.0865440740148
522,2018-08-25,6719.95,6789.63,6700.96,6763.19,6763.19,3312600000,BTC,84.2348201656902500000,6430.762667,0.05169329832461068,1,213660637264,6295.73,6763.19,0.0742503252204
523,2018-08-26,6754.64,6774.75,6620.75,6707.26,6707.26,3295500000,BTC,94.6297042874160000000,6458.198000,0.03856524683820471,-1,210365137264,6322.69,6707.26,0.0608237949354
524,2018-08-27,6710.80,6884.64,6689.71,6884.64,6884.64,4019000000,BTC,97.5185454674522500000,6495.661333,0.05988284287911782,1,214384137264,6297.57,6884.64,0.0932216712160
525,2018-08-28,6891.08,7109.56,6882.34,7096.28,7096.28,4659940000,BTC,97.5185454674522500000,6548.908667,0.08358206852970912,1,219044077264,6199.71,7096.28,0.1446148287581
526,2018-08-29,7091.71,7113.30,6970.82,7047.16,7047.16,4145880000,BTC,95.9596950561595000000,6605.405333,0.06687775310215017,-1,214898197264,6308.52,7047.16,0.1170860994338
527,2018-08-30,7043.76,7072.69,6834.69,6978.23,6978.23,4463250000,BTC,94.6947198838517500000,6650.052667,0.04934958404593339,-1,210434947264,6334.73,6978.23,0.1015828614637
528,2018-08-31,6973.97,7057.17,6920.16,7037.58,7037.58,4495650000,BTC,92.8318192173967500000,6696.909333,0.05086983413696457,1,214930597264,6580.63,7037.58,0.0694386403733
529,2018-09-01,7044.81,7242.29,7038.05,7193.25,7193.25,4116050000,BTC,92.8318192173967500000,6737.750667,0.06760406484480557,1,219046647264,6423.76,7193.25,0.1197880991818
530,2018-09-02,7189.58,7306.31,7132.16,7272.72,7272.72,4329540000,BTC,94.3906696286895000000,6794.348000,0.07040734445748142,1,223376187264,6506.07,7272.72,0.1178361130452
531,2018-09-03,7279.03,7317.94,7208.15,7260.06,7260.06,4087760000,BTC,97.8088445289940000000,6844.614000,0.06069677559611104,-1,219288427264,6308.53,7260.06,0.1508322858098
532,2018-09-04,7263.00,7388.26,7255.44,7361.66,7361.66,4273640000,BTC,99.6717451954490000000,6914.822667,0.06462021580574541,1,223562067264,6488.76,7361.66,0.1345249323445
533,2018-09-05,7361.46,7388.43,6792.83,6792.83,6792.83,5800460000,BTC,85.2337026552185000000,6935.094000,-0.02051363687355932,-1,217761607264,6376.71,6792.83,0.0652562214684
534,2018-09-06,6755.14,6755.14,6404.72,6529.17,6529.17,5523470000,BTC,60.2337026552185000000,6945.258000,-0.05990965346427735,-1,212238137264,6534.88,6529.17,-0.0008737727395
535,2018-09-07,6528.92,6555.29,6396.87,6467.07,6467.07,4264680000,BTC,35.5619574597695000000,6940.737333,-0.06824452652140150,-1,207973457264,6719.96,6467.07,-0.0376326644801
536,2018-09-08,6460.17,6534.25,6197.52,6225.98,6225.98,3835060000,BTC,10.5619574597695000000,6907.805333,-0.09870361136883531,-1,204138397264,6763.19,6225.98,-0.0794314517262
537,2018-09-09,6223.38,6446.26,6201.22,6300.86,6300.86,3671890000,BTC,1.6483516483517500000,6876.983333,-0.08377558954307851,1,207810287264,6707.26,6300.86,-0.0605910610294
538,2018-09-10,6301.57,6374.98,6292.76,6329.70,6329.70,3714100000,BTC,3.9315652296422500000,6851.812667,-0.07620066285738107,1,211524387264,6884.64,6329.70,-0.0806055218574
539,2018-09-11,6331.88,6398.92,6260.21,6321.20,6321.20,3849910000,BTC,6.0276662440125000000,6814.250000,-0.07235572513482775,-1,207674477264,7096.28,6321.20,-0.1092234241039
540,2018-09-12,6317.01,6363.87,6265.09,6351.80,6351.80,4064230000,BTC,8.7973724992957500000,6764.618000,-0.06102606237336683,1,211738707264,7047.16,6351.80,-0.0986723729843
541,2018-09-13,6354.24,6535.41,6354.24,6517.31,6517.31,4210910000,BTC,13.5621389828122500000,6729.294667,-0.03150176615679475,1,215949617264,6978.23,6517.31,-0.0660511333103
542,2018-09-14,6515.41,6596.10,6456.17,6512.71,6512.71,4076220000,BTC,17.5907826148212500000,6698.260000,-0.02770122389993819,-1,211873397264,7037.58,6512.71,-0.0745810349580
543,2018-09-15,6509.40,6561.72,6493.55,6543.20,6543.20,3216300000,BTC,22.4777225979150000000,6665.301333,-0.01831895167221842,1,215089697264,7193.25,6543.20,-0.0903694435756
544,2018-09-16,6536.68,6544.33,6460.10,6517.18,6517.18,3273730000,BTC,26.1182727528882500000,6620.230000,-0.01556592444673372,-1,211815967264,7272.72,6517.18,-0.1038868538869
545,2018-09-17,6514.06,6540.21,6257.52,6281.20,6281.20,3910780000,BTC,20.9207259087067500000,6554.128667,-0.04164225038397465,-1,207905187264,7260.06,6281.20,-0.1348280868202
546,2018-09-18,6280.91,6384.18,6265.71,6371.30,6371.30,4180090000,BTC,17.8078331924487500000,6494.878000,-0.01902699327069731,1,212085277264,7361.66,6371.30,-0.1345294403708
547,2018-09-19,6371.85,6448.46,6208.34,6398.54,6398.54,4431340000,BTC,18.4352711576732500000,6430.670000,-0.00499636896310960,1,216516617264,6792.83,6398.54,-0.0580450268886
548,2018-09-20,6398.85,6529.26,6395.95,6519.67,6519.67,4348110000,BTC,35.1706234732222500000,6412.459333,0.01671911842750707,1,220864727264,6529.17,6519.67,-0.0014550088296
549,2018-09-21,6513.87,6794.33,6496.36,6734.95,6734.95,6531940000,BTC,58.9550521855355000000,6426.178000,0.04804908920979157,1,227396667264,6467.07,6734.95,0.0414221587210
550,2018-09-22,6735.05,6814.56,6616.80,6721.98,6721.98,4509660000,BTC,80.1190167412870000000,6443.172000,0.04327185429785205,-1,222887007264,6225.98,6721.98,0.0796661730362
551,2018-09-23,6715.32,6766.15,6679.42,6710.63,6710.63,4197500000,BTC,96.1685928750172500000,6475.482000,0.03631359024702717,-1,218689507264,6300.86,6710.63,0.0650339794885
552,2018-09-24,6704.77,6713.56,6580.90,6595.41,6595.41,4177310000,BTC,90.3348298792392500000,6495.118667,0.01544103166421794,-1,214512197264,6329.70,6595.41,0.0419782928101
553,2018-09-25,6603.64,6603.64,6381.86,6446.47,6446.47,4726180000,BTC,74.4406150032062500000,6502.903333,-0.00867817497972332,-1,209786017264,6321.20,6446.47,0.0198174397266
554,2018-09-26,6452.79,6585.91,6397.89,6495.00,6495.00,4437300000,BTC,61.8573002754820000000,6514.490000,-0.00299179214336042,1,214223317264,6351.80,6495.00,0.0225447904531
555,2018-09-27,6495.29,6712.10,6464.95,6676.75,6676.75,4606810000,BTC,59.9906336088152500000,6536.153333,0.02151061332820174,1,218830127264,6517.31,6676.75,0.0244640810396
556,2018-09-28,6678.75,6785.03,6598.32,6644.13,6644.13,5014430000,BTC,62.6749311294765000000,6544.608000,0.01520671673536444,-1,213815697264,6512.71,6644.13,0.0201790038248
557,2018-09-29,6643.10,6643.10,6511.65,6601.96,6601.96,4363690000,BTC,71.2418732782367500000,6550.558000,0.00784696509824049,-1,209452007264,6543.20,6601.96,0.0089803154420
558,2018-09-30,6604.71,6643.78,6566.54,6625.56,6625.56,4002280000,BTC,78.4352617079890000000,6556.048667,0.01060262614429430,1,213454287264,6517.18,6625.56,0.0166298920699
559,2018-10-01,6619.85,6653.30,6549.08,6589.62,6589.62,4000970000,BTC,73.6347107438017500000,6560.878000,0.00438081610418606,-1,209453317264,6281.20,6589.62,0.0491020824046
560,2018-10-02,6593.24,6611.84,6537.90,6556.10,6556.10,3979260000,BTC,66.3430910734787500000,6579.204667,-0.00351177204075874,-1,205474057264,6371.30,6556.10,0.0290050696090
561,2018-10-03,6553.86,6571.46,6454.03,6502.59,6502.59,3887310000,BTC,56.4027439321387500000,6587.957333,-0.01295808832464398,-1,201586747264,6398.54,6502.59,0.0162615221597
562,2018-10-04,6497.91,6603.31,6497.91,6576.69,6576.69,3838410000,BTC,48.7147522699412500000,6599.834000,-0.00350675486686483,1,205425157264,6519.67,6576.69,0.0087458414306
563,2018-10-05,6574.15,6623.62,6557.41,6622.48,6622.48,3671500000,BTC,46.9751385980537500000,6606.688000,0.00239030509689575,1,209096657264,6734.95,6622.48,-0.0166994558237
564,2018-10-06,6622.45,6628.54,6577.80,6588.31,6588.31,3259740000,BTC,47.1412912181890000000,6596.912000,-0.00130394342080052,-1,205836917264,6721.98,6588.31,-0.0198855099242
565,2018-10-07,6590.68,6641.49,6557.04,6602.95,6602.95,3306630000,BTC,54.2181176282917500000,6588.976667,0.00212071368684360,1,209143547264,6710.63,6602.95,-0.0160461834433
566,2018-10-08,6600.19,6675.06,6576.04,6652.23,6652.23,3979460000,BTC,65.2711298116800000000,6585.083333,0.01019678318473301,1,213123007264,6595.41,6652.23,0.0086150823072
567,2018-10-09,6653.08,6661.41,6606.94,6642.64,6642.64,3580810000,BTC,71.3148054447875000000,6588.232000,0.00825836127203778,-1,209542197264,6446.47,6642.64,0.0304306077590
568,2018-10-10,6640.29,6640.29,6538.96,6585.53,6585.53,3787650000,BTC,70.8966739485505000000,6597.502667,-0.00181472711786628,-1,205754547264,6495.00,6585.53,0.0139384141647
569,2018-10-11,6586.74,6586.74,6243.74,6256.24,6256.24,5181640000,BTC,56.0874674070605000000,6581.585333,-0.04943266956803278,-1,200572907264,6676.75,6256.24,-0.0629812408732
570,2018-10-12,6239.25,6328.50,6236.47,6274.58,6274.58,3783500000,BTC,34.9073016527032500000,6554.774000,-0.04274655388576326,1,204356407264,6644.13,6274.58,-0.0556205251854
571,2018-10-13,6278.08,6308.51,6259.81,6285.99,6285.99,3064030000,BTC,15.4886062209690000000,6530.898000,-0.03749989664514742,1,207420437264,6601.96,6285.99,-0.0478600294458
572,2018-10-14,6288.49,6363.21,6280.15,6290.93,6290.93,3085320000,BTC,5.2261420742947500000,6510.162667,-0.03367545147700992,1,210505757264,6625.56,6290.93,-0.0505059194996
573,2018-10-15,6292.64,6965.06,6258.68,6596.54,6596.54,7370770000,BTC,26.7102704613752500000,6508.228000,0.01356928491134607,1,217876527264,6589.62,6596.54,0.0010501364267
574,2018-10-16,6601.41,6673.59,6571.37,6596.11,6596.11,4074800000,BTC,47.0093941766207500000,6508.660667,0.01343584148477470,-1,213801727264,6556.10,6596.11,0.0061027135035
575,2018-10-17,6590.52,6601.21,6517.45,6544.43,6544.43,4088420000,BTC,63.3254627642112500000,6507.882667,0.00561585616552727,-1,209713307264,6502.59,6544.43,0.0064343592322
576,2018-10-18,6542.33,6567.54,6450.04,6476.71,6476.71,3924080000,BTC,75.0542943003612500000,6506.157333,-0.00452607145705494,-1,205789227264,6576.69,6476.71,-0.0152021761707
577,2018-10-19,6478.07,6493.68,6445.31,6465.41,6465.41,3578870000,BTC,66.7756761534382500000,6498.738667,-0.00512848241909463,-1,202210357264,6622.48,6465.41,-0.0237177009217
578,2018-10-20,6460.92,6497.72,6449.00,6489.19,6489.19,3379130000,BTC,60.0255056945882500000,6489.852667,-0.00010210817317465,1,205589487264,6588.31,6489.19,-0.0150448294024
579,2018-10-21,6490.09,6556.38,6476.00,6482.35,6482.35,3253610000,BTC,56.1062148034040000000,6482.788667,-0.00006766640446464,-1,202335877264,6602.95,6482.35,-0.0182645635663
580,2018-10-22,6486.05,6543.80,6462.98,6487.16,6487.16,3672860000,BTC,56.7659536856990000000,6475.069333,0.00186726448447127,1,206008737264,6652.23,6487.16,-0.0248142352264
581,2018-10-23,6472.36,6506.01,6451.27,6475.74,6475.74,3716150000,BTC,57.7620480004070000000,6463.303333,0.00192419670859350,1,209724887264,6642.64,6475.74,-0.0251255524912
582,2018-10-24,6478.89,6521.99,6468.86,6495.84,6495.84,3424670000,BTC,60.6573530025510000000,6453.516667,0.00655818140463168,1,213149557264,6585.53,6495.84,-0.0136192531201
583,2018-10-25,6484.65,6504.65,6447.03,6476.29,6476.29,3230550000,BTC,62.5482543554667500000,6446.234000,0.00466256732225358,-1,209919007264,6256.24,6476.29,0.0351728833932
584,2018-10-26,6468.44,6498.29,6449.61,6474.75,6474.75,3306050000,BTC,63.5126832651320000000,6460.801333,0.00215896856768433,1,213225057264,6274.58,6474.75,0.0319017368493
585,2018-10-27,6480.84,6507.41,6453.53,6480.38,6480.38,3393250000,BTC,64.9599275268822500000,6474.521333,0.00090488032993867,-1,209831807264,6285.99,6480.38,0.0309243253648
586,2018-10-28,6482.66,6502.28,6447.91,6486.39,6486.39,3445190000,BTC,63.3471445564785000000,6487.881333,-0.00022986440772498,1,213276997264,6290.93,6486.39,0.0310701279461
587,2018-10-29,6492.35,6503.60,6306.99,6332.63,6332.63,4199910000,BTC,47.1812615121060000000,6490.661333,-0.02434749325103942,-1,209077087264,6596.54,6332.63,-0.0400073371798
588,2018-10-30,6337.04,6364.99,6310.14,6334.27,6334.27,3781100000,BTC,31.7937911603365000000,6473.176667,-0.02145880981561043,-1,205295987264,6596.11,6334.27,-0.0396961239276
589,2018-10-31,6336.99,6349.16,6316.88,6317.61,6317.61,4191240000,BTC,16.1449423437207500000,6454.610000,-0.02122513986127744,-1,201104747264,6544.43,6317.61,-0.0346584805705
590,2018-11-01,6318.14,6547.14,6311.83,6377.78,6377.78,3789400000,BTC,8.5955466937802500000,6443.500000,-0.01019942577791573,1,204894147264,6476.71,6377.78,-0.0152747305345
591,2018-11-02,6378.92,6396.86,6327.38,6388.44,6388.44,4234870000,BTC,18.5307427887137500000,6437.615333,-0.00763874982525303,1,209129017264,6465.41,6388.44,-0.0119048907958
592,2018-11-03,6387.24,6400.07,6342.37,6361.26,6361.26,3658640000,BTC,24.4978398698312500000,6430.672000,-0.01079389525698092,-1,205470377264,6489.19,6361.26,-0.0197143249003
593,2018-11-04,6365.47,6388.63,6294.57,6376.13,6376.13,4390020000,BTC,32.7063345115862500000,6423.134667,-0.00731802607868318,1,209860397264,6482.35,6376.13,-0.0163860328430
594,2018-11-05,6363.62,6480.59,6363.62,6419.66,6419.66,4174800000,BTC,38.5807664254052500000,6418.955333,0.00010977907828355,1,214035197264,6487.16,6419.66,-0.0104051695966
595,2018-11-06,6433.38,6463.55,6408.16,6461.01,6461.01,4700040000,BTC,48.7600291757840000000,6417.212000,0.00682508229430475,1,218735237264,6475.74,6461.01,-0.0022746435156
596,2018-11-07,6468.50,6552.16,6468.31,6530.14,6530.14,4941260000,BTC,67.6373225607360000000,6420.838667,0.01702290598917489,1,223676497264,6495.84,6530.14,0.0052803024705
597,2018-11-08,6522.27,6536.92,6438.53,6453.72,6453.72,4665260000,BTC,75.4395087640382500000,6418.030667,0.00556079190825718,-1,219011237264,6476.29,6453.72,-0.0034850199729
598,2018-11-09,6442.60,6456.46,6373.37,6385.62,6385.62,4346820000,BTC,69.1251867425502500000,6411.986000,-0.00411198652024505,-1,214664417264,6474.75,6385.62,-0.0137657824626
599,2018-11-10,6386.13,6437.28,6385.31,6409.22,6409.22,3705320000,BTC,59.7868536206652500000,6407.617333,0.00025011902501513,1,218369737264,6480.38,6409.22,-0.0109808375435
600,2018-11-11,6413.63,6423.25,6350.17,6411.27,6411.27,3939060000,BTC,45.8041217710440000000,6403.010000,0.00129001828827380,-1,214430677264,6486.39,6411.27,-0.0115811722699
601,2018-11-12,6411.76,6434.21,6360.47,6371.27,6371.27,4295770000,BTC,36.1054909895072500000,6395.335333,-0.00376295092390584,-1,210134907264,6332.63,6371.27,0.0061017302448
602,2018-11-13,6373.19,6395.27,6342.67,6359.49,6359.49,4503800000,BTC,33.0318072742672500000,6397.126000,-0.00588326695456679,-1,205631107264,6334.27,6359.49,0.0039815164178
603,2018-11-14,6351.24,6371.55,5544.09,5738.35,5738.35,7398940000,BTC,22.2556815508400000000,6357.398000,-0.09737442897235630,-1,198232167264,6317.61,5738.35,-0.0916897370999
604,2018-11-15,5736.15,5774.82,5358.38,5648.03,5648.03,7032140000,BTC,11.2384134004612500000,6312.759333,-0.10529933075780698,-1,191200027264,6377.78,5648.03,-0.1144206918395
605,2018-11-16,5645.32,5657.02,5498.94,5575.55,5575.55,5279320000,BTC,4.9263633369407500000,6259.277333,-0.10923422890934556,-1,185920707264,6388.44,5575.55,-0.1272438967886
606,2018-11-17,5578.58,5578.58,5519.56,5554.33,5554.33,4303150000,BTC,0E-19,6203.670000,-0.10467029999983881,-1,181617557264,6361.26,5554.33,-0.1268506553733
607,2018-11-18,5559.74,5653.61,5559.74,5623.54,5623.54,4159680000,BTC,1.7731423125402500000,6154.488667,-0.08627015106013843,1,185777237264,6376.13,5623.54,-0.1180324115098
608,2018-11-19,5620.78,5620.78,4842.91,4871.49,4871.49,7039560000,BTC,1.7731423125402500000,6054.179333,-0.19535089199512485,-1,178737677264,6419.66,4871.49,-0.2411607468308
609,2018-11-20,4863.93,4951.61,4272.11,4451.87,4451.87,8428290000,BTC,1.7731423125402500000,5922.993333,-0.24837497702447608,-1,170309387264,6461.01,4451.87,-0.3109637657270
610,2018-11-21,4465.54,4675.73,4343.98,4602.17,4602.17,6120120000,BTC,3.5811364615200000000,5799.070667,-0.20639525464158307,1,176429507264,6530.14,4602.17,-0.2952417559195
611,2018-11-22,4611.57,4629.64,4365.64,4365.94,4365.94,4569370000,BTC,1.8079941489797500000,5654.790667,-0.22792190602588048,-1,171860137264,6453.72,4365.94,-0.3235002448200
612,2018-11-23,4360.70,4396.42,4195.68,4347.11,4347.11,4871490000,BTC,1.8079941489797500000,5514.350000,-0.21167317997588111,-1,166988647264,6385.62,4347.11,-0.3192344674440
613,2018-11-24,4347.69,4413.09,3795.16,3880.76,3880.76,4679500000,BTC,1.8079941489797500000,5347.359333,-0.27426608942272105,-1,162309147264,6409.22,3880.76,-0.3945035433329
614,2018-11-25,3880.78,4120.87,3585.06,4009.97,4009.97,6825640000,BTC,1.2765213336442500000,5187.409333,-0.22698022411874317,1,169134787264,6411.27,4009.97,-0.3745435771696
615,2018-11-26,4015.07,4107.14,3643.92,3779.13,3779.13,6476900000,BTC,1.2765213336442500000,5011.933333,-0.24597360960148270,-1,162657887264,6371.27,3779.13,-0.4068482421872
616,2018-11-27,3765.95,3862.96,3661.01,3820.72,3820.72,5998720000,BTC,1.6794689843597500000,4841.896667,-0.21090426690842884,1,168656607264,6359.49,3820.72,-0.3992096850534
617,2018-11-28,3822.47,4385.90,3822.47,4257.42,4257.42,7280280000,BTC,7.7825355108345000000,4701.758667,-0.09450477969417225,1,175936887264,5738.35,4257.42,-0.2580759277493
618,2018-11-29,4269.00,4413.02,4145.77,4278.85,4278.85,6503347767,BTC,13.1906950054850000000,4604.458667,-0.07071594959329885,1,182440235031,5648.03,4278.85,-0.2424172676137
619,2018-11-30,4289.09,4322.98,3942.82,4017.27,4017.27,6048016717,BTC,16.4185564896452500000,4495.741333,-0.10642768290245848,-1,176392218314,5575.55,4017.27,-0.2794845351580
620,2018-12-01,4024.46,4309.38,3969.71,4214.67,4214.67,5375314093,BTC,21.9191226997307500000,4405.016000,-0.04321119378454017,1,181767532407,5554.33,4214.67,-0.2411920069567
621,2018-12-02,4200.73,4301.52,4110.98,4139.88,4139.88,5262697895,BTC,20.7058312232720000000,4310.719333,-0.03963128188192808,-1,176504834512,5623.54,4139.88,-0.2638302563865
622,2018-12-03,4147.32,4155.98,3840.45,3894.13,3894.13,5089570994,BTC,16.6530666130737500000,4195.425333,-0.07181520563126180,-1,171415263518,4871.49,3894.13,-0.2006285551238
623,2018-12-04,3886.29,4075.63,3832.75,3956.89,3956.89,5028069239,BTC,18.8246996856787500000,4134.452000,-0.04294692500965061,1,176443332757,4451.87,3956.89,-0.1111847380988
624,2018-12-05,3958.89,3969.54,3753.99,3753.99,3753.99,5302481574,BTC,12.9211858248777500000,4087.926667,-0.08168851699217627,-1,171140851183,4602.17,3753.99,-0.1843000149929
625,2018-12-06,3754.07,3874.97,3521.10,3521.10,3521.10,5878333109,BTC,8.0314107748617500000,4015.855333,-0.12320048706296363,-1,165262518074,4365.94,3521.10,-0.1935070110904
626,2018-12-07,3512.59,3512.59,3280.23,3419.94,3419.94,6835615448,BTC,5.3994945567652500000,3952.788667,-0.13480322675697451,-1,158426902626,4347.11,3419.94,-0.2132842279123
627,2018-12-08,3421.91,3506.04,3350.65,3476.11,3476.11,5305024497,BTC,1.6349210045290000000,3894.722000,-0.10748186905252801,1,163731927123,3880.76,3476.11,-0.1042708129335
628,2018-12-09,3473.23,3685.31,3469.09,3614.23,3614.23,4947372847,BTC,7.2900536726782500000,3876.953333,-0.06776541021624931,1,168679299970,4009.97,3614.23,-0.0986890176236
629,2018-12-10,3612.05,3647.33,3470.14,3502.66,3502.66,5020968740,BTC,9.6977564587675000000,3843.132667,-0.08859248339864818,-1,163658331230,3779.13,3502.66,-0.0731570493738
630,2018-12-11,3497.55,3513.19,3392.25,3424.59,3424.59,4696765188,BTC,9.8331024205097500000,3819.496667,-0.10339233187763900,-1,158961566042,3820.72,3424.59,-0.1036794112105
631,2018-12-12,3421.46,3534.23,3413.48,3486.95,3486.95,4139364829,BTC,10.1486185979905000000,3797.245333,-0.08171590344805356,1,163100930871,4257.42,3486.95,-0.1809711045657
632,2018-12-13,3487.88,3489.74,3298.13,3313.68,3313.68,4343372456,BTC,4.4934859298412500000,3734.329333,-0.11264387671509100,-1,158757558415,4278.85,3313.68,-0.2255676174673
633,2018-12-14,3311.75,3329.56,3206.54,3242.48,3242.48,4372763663,BTC,2.0857831437520000000,3665.238000,-0.11534257802631098,-1,154384794752,4017.27,3242.48,-0.1928648061992
634,2018-12-15,3244.00,3275.38,3191.30,3236.76,3236.76,3551763561,BTC,1.9504371820097500000,3613.204000,-0.10418564797337764,-1,150833031191,4214.67,3236.76,-0.2320252831183
635,2018-12-16,3236.27,3305.75,3233.82,3252.84,3252.84,3744248994,BTC,0.4451235716185000000,3549.082000,-0.08347003534998628,1,154577280185,4139.88,3252.84,-0.2142670802052
636,2018-12-17,3253.12,3597.92,3253.12,3545.86,3545.86,5409247918,BTC,11.1758249727545000000,3509.480667,0.01036601607242876,1,159986528103,3894.13,3545.86,-0.0894346105549
637,2018-12-18,3544.76,3701.35,3487.17,3696.06,3696.06,5911325473,BTC,27.1208626742805000000,3496.276000,0.05714194188330670,1,165897853576,3956.89,3696.06,-0.0659179304959
638,2018-12-19,3706.82,3949.32,3687.23,3745.95,3745.95,6810689119,BTC,51.7322541248925000000,3482.213333,0.07573822789679153,1,172708542695,3753.99,3745.95,-0.0021417212086
639,2018-12-20,3742.20,4191.23,3728.97,4134.44,4134.44,8927129279,BTC,76.2871305532740000000,3507.576667,0.17871692981016172,1,181635671974,3521.10,4134.44,0.1741898838431
640,2018-12-21,4133.70,4198.43,3850.95,3896.54,3896.54,7206015706,BTC,83.9310169785350000000,3532.606000,0.10302139553632644,-1,174429656268,3419.94,3896.54,0.1393591700439
641,2018-12-22,3898.08,4014.18,3855.74,4014.18,4014.18,5605823233,BTC,89.6367902564225000000,3572.222000,0.12372075419724754,1,180035479501,3476.11,4014.18,0.1547908437880
642,2018-12-23,4020.99,4085.72,3976.41,3998.98,3998.98,6151275490,BTC,86.2528963550485000000,3607.080000,0.10864743781673819,-1,173884204011,3614.23,3998.98,0.1064542101637
643,2018-12-24,4000.33,4271.79,4000.33,4078.60,4078.60,7240968501,BTC,84.6977764905087500000,3638.038000,0.12109879006211590,1,181125172512,3502.66,4078.60,0.1644293194315
644,2018-12-25,4081.03,4089.56,3760.02,3815.49,3815.49,6158207293,BTC,82.4405690223685000000,3658.893333,0.04279891561408358,-1,174966965219,3424.59,3815.49,0.1141450509404
645,2018-12-26,3819.67,3893.36,3769.86,3857.30,3857.30,5326547918,BTC,78.0715288298725000000,3687.740667,0.04597919113925589,1,180293513137,3486.95,3857.30,0.1062102983983
646,2018-12-27,3854.69,3874.42,3645.45,3654.83,3654.83,5130222366,BTC,68.4871000802067500000,3698.932667,-0.01192307916104059,-1,175163290771,3313.68,3654.83,0.1029520050216
647,2018-12-28,3653.13,3956.14,3642.63,3923.92,3923.92,5631554348,BTC,64.1793289368150000000,3739.615333,0.04928439173238356,1,180794845119,3242.48,3923.92,0.2101601243493
648,2018-12-29,3932.49,3963.76,3820.41,3820.41,3820.41,4991655917,BTC,64.3163488102667500000,3778.144000,0.01118697434507525,-1,175803189202,3236.76,3820.41,0.1803192080970
649,2018-12-30,3822.38,3901.91,3797.22,3865.95,3865.95,4770578575,BTC,64.4208643209900000000,3820.090000,0.01200495276289302,1,180573767777,3252.84,3865.95,0.1884845242926
650,2018-12-31,3866.84,3868.74,3725.87,3742.70,3742.70,4661840806,BTC,61.1385960922832500000,3852.747333,-0.02856334025784919,-1,175911926971,3545.86,3742.70,0.0555126259920
651,2019-01-01,3746.71,3850.91,3707.23,3843.52,3843.52,4324200990,BTC,51.8370826882967500000,3872.591333,-0.00750694573741122,1,180236127961,3696.06,3843.52,0.0398965384761
652,2019-01-02,3849.22,3947.98,3817.41,3943.41,3943.41,5244856836,BTC,50.6251127645467500000,3889.081333,0.01396953736580546,1,185480984797,3745.95,3943.41,0.0527129299644
653,2019-01-03,3931.05,3935.69,3826.22,3836.74,3836.74,4530215219,BTC,42.7210099076182500000,3895.134000,-0.01499152532364740,-1,180950769578,4134.44,3836.74,-0.0720049148131
654,2019-01-04,3832.04,3865.93,3783.85,3857.72,3857.72,4847965467,BTC,46.3295559162652500000,3876.686000,-0.00489232297895677,1,185798735045,3896.54,3857.72,-0.0099626848435
655,2019-01-05,3851.97,3904.90,3836.90,3845.19,3845.19,5137609824,BTC,47.7241087577560000000,3873.262667,-0.00724780873736700,-1,180661125221,4014.18,3845.19,-0.0420982616624
656,2019-01-06,3836.52,4093.30,3826.51,4076.63,4076.63,5597027440,BTC,57.5654597462555000000,3877.426000,0.05137531960635741,1,186258152661,3998.98,4076.63,0.0194174514501
657,2019-01-07,4078.58,4092.61,4020.89,4025.25,4025.25,5228625637,BTC,69.9359322273877500000,3879.177333,0.03765557860873384,-1,181029527024,4078.60,4025.25,-0.0130804687883
658,2019-01-08,4028.47,4109.02,3996.96,4030.85,4030.85,5306593305,BTC,80.2532143818725000000,3875.994000,0.03995259022588786,1,186336120329,3815.49,4030.85,0.0564436022634
659,2019-01-09,4031.55,4068.40,4022.66,4035.30,4035.30,5115905225,BTC,91.5734452789947500000,3890.648000,0.03717941073055183,1,191452025554,3857.30,4035.30,0.0461462681150
660,2019-01-10,4034.41,4064.07,3659.17,3678.92,3678.92,6874143796,BTC,68.1174733708725000000,3878.756000,-0.05152064218527796,-1,184577881758,3654.83,3678.92,0.0065912778433
661,2019-01-11,3674.02,3713.88,3653.07,3687.37,3687.37,5538712865,BTC,46.7959833739482500000,3880.925333,-0.04987350087727132,1,190116594623,3923.92,3687.37,-0.0602841036515
662,2019-01-12,3686.97,3698.98,3653.81,3661.30,3661.30,4778170883,BTC,24.5093546399510000000,3863.417333,-0.05231568727343596,-1,185338423740,3820.41,3661.30,-0.0416473624559
663,2019-01-13,3658.87,3674.76,3544.93,3552.95,3552.95,4681302466,BTC,1.9589753132560000000,3845.586667,-0.07609675514823081,-1,180657121274,3865.95,3552.95,-0.0809632819876
664,2019-01-14,3557.31,3727.84,3552.29,3706.05,3706.05,5651384490,BTC,7.8400186594145000000,3834.926667,-0.03360603166391656,1,186308505764,3742.70,3706.05,-0.0097923958639
665,2019-01-15,3704.22,3720.15,3619.95,3630.68,3630.68,5537192302,BTC,11.0196112129545000000,3827.458667,-0.05141235585288164,-1,180771313462,3843.52,3630.68,-0.0553763217051
666,2019-01-16,3631.51,3685.78,3624.67,3655.01,3655.01,5394457145,BTC,15.8918614421020000000,3814.891333,-0.04190980005563372,1,186165770607,3943.41,3655.01,-0.0731346727832
667,2019-01-17,3651.87,3680.14,3621.96,3678.56,3678.56,5464420383,BTC,21.8883669416437500000,3797.234667,-0.03125291887576671,1,191630190990,3836.74,3678.56,-0.0412277089404
668,2019-01-18,3677.99,3682.52,3637.08,3657.84,3657.84,5002961727,BTC,19.5868660250535000000,3785.308000,-0.03367440641554135,-1,186627229263,3857.72,3657.84,-0.0518129879825
669,2019-01-19,3652.38,3758.53,3652.38,3728.57,3728.57,5955691380,BTC,24.2600443018637500000,3776.698000,-0.01274340707146825,1,192582920643,3845.19,3728.57,-0.0303288003974
670,2019-01-20,3725.45,3743.39,3583.02,3601.01,3601.01,5582489560,BTC,21.6821341277117500000,3760.419333,-0.04239137151569367,-1,187000431083,4076.63,3601.01,-0.1166698964586
671,2019-01-21,3600.37,3608.84,3558.54,3576.03,3576.03,5004347059,BTC,16.8818554344310000000,3727.046000,-0.04051895254311323,-1,181996084024,4025.25,3576.03,-0.1116005217067
672,2019-01-22,3575.08,3620.75,3539.72,3604.58,3604.58,5313623556,BTC,14.5504650553162500000,3699.001333,-0.02552616895745250,1,187309707580,4030.85,3604.58,-0.1057518885595
673,2019-01-23,3605.56,3623.07,3565.31,3585.12,3585.12,5433755649,BTC,7.8338860278367500000,3669.286000,-0.02293797757928927,-1,181875951931,4035.30,3585.12,-0.1115604787748
674,2019-01-24,3584.50,3616.09,3569.09,3600.87,3600.87,5262869046,BTC,12.3610924937387500000,3640.324000,-0.01083804628379232,1,187138820977,3678.92,3600.87,-0.0212154654083
675,2019-01-25,3607.39,3612.93,3575.60,3599.77,3599.77,5265847539,BTC,17.8298241204580000000,3635.047333,-0.00970477954433833,-1,181872973438,3687.37,3599.77,-0.0237567697302
676,2019-01-26,3599.72,3654.93,3593.35,3602.46,3602.46,5098183235,BTC,22.2017501660100000000,3629.386667,-0.00741906814306374,1,186971156673,3661.30,3602.46,-0.0160707945265
677,2019-01-27,3604.69,3612.67,3567.25,3583.97,3583.97,5570752966,BTC,24.9501765174810000000,3624.231333,-0.01110893022567442,-1,181400403707,3552.95,3583.97,0.0087307730196
678,2019-01-28,3584.28,3586.75,3439.23,3470.45,3470.45,6908930483,BTC,18.1286299965835000000,3618.731333,-0.04097605468739561,-1,174491473224,3706.05,3470.45,-0.0635717273107
679,2019-01-29,3468.87,3476.07,3400.82,3448.12,3448.12,5897159493,BTC,11.4636715636032500000,3601.536000,-0.04259738067313502,-1,168594313731,3630.68,3448.12,-0.0502825916908
680,2019-01-30,3443.90,3495.17,3429.39,3486.18,3486.18,5955112627,BTC,7.8085457123517500000,3591.902667,-0.02943361132006977,1,174549426358,3655.01,3486.18,-0.0461913920892
681,2019-01-31,3485.41,3504.80,3447.92,3457.79,3457.79,5831198271,BTC,4.2547691210555000000,3578.754667,-0.03380077100993411,-1,168718228087,3678.56,3457.79,-0.0600153320865
682,2019-02-01,3460.55,3501.95,3431.59,3487.95,3487.95,5422926707,BTC,7.8053128899982500000,3566.047333,-0.02190025137279915,1,174141154794,3657.84,3487.95,-0.0464454432124
683,2019-02-02,3484.63,3523.29,3467.57,3521.06,3521.06,5071623601,BTC,14.3073631663397500000,3556.928667,-0.01008416821309282,1,179212778395,3728.57,3521.06,-0.0556540443119
684,2019-02-03,3516.14,3521.39,3447.92,3464.01,3464.01,5043937584,BTC,13.4535891339147500000,3539.291333,-0.02127017131878474,-1,174168840811,3601.01,3464.01,-0.0380448818526
685,2019-02-04,3467.21,3476.22,3442.59,3459.15,3459.15,5332718886,BTC,14.3540129382920000000,3529.834000,-0.02002473770721229,-1,168836121925,3576.03,3459.15,-0.0326842895613
686,2019-02-05,3454.95,3478.15,3451.94,3466.36,3466.36,5227549545,BTC,13.7179521042847500000,3522.522667,-0.01594387667853721,1,174063671470,3604.58,3466.36,-0.0383456602434
687,2019-02-06,3469.09,3469.09,3398.57,3413.77,3413.77,5482196038,BTC,7.2159018279432500000,3509.802000,-0.02736108760551165,-1,168581475432,3585.12,3413.77,-0.0477947739546
688,2019-02-07,3414.93,3427.95,3394.22,3399.47,3399.47,5004962683,BTC,4.6769142272785000000,3497.425333,-0.02800784110406625,-1,163576512749,3600.87,3399.47,-0.0559309278036
689,2019-02-08,3401.38,3695.61,3391.02,3666.78,3666.78,7735623101,BTC,27.9144829349355000000,3501.819333,0.04710713241127680,1,171312135850,3599.77,3666.78,0.0186150781856
690,2019-02-09,3671.59,3679.94,3646.56,3671.20,3671.20,6158833645,BTC,50.0000000000000000000,3506.581333,0.04694562919467866,-1,165153302205,3602.46,3671.20,0.0190814054840
691,2019-02-10,3673.20,3695.04,3640.98,3690.19,3690.19,6282256903,BTC,75.0000000000000000000,3512.430000,0.05060883775619728,1,171435559108,3583.97,3690.19,0.0296375248677
692,2019-02-11,3695.61,3695.61,3642.29,3648.43,3648.43,6277056434,BTC,96.4089157952670000000,3516.727333,0.03745034929610222,-1,165158502674,3470.45,3648.43,0.0512844155657
693,2019-02-12,3642.75,3668.59,3618.56,3653.53,3653.53,6480384532,BTC,93.2563979086407500000,3528.932667,0.03530737045938655,1,171638887206,3448.12,3653.53,0.0595715926360
694,2019-02-13,3653.60,3669.75,3617.25,3632.07,3632.07,6438903823,BTC,88.2584617501377500000,3541.196000,0.02566195149887213,-1,165199983383,3486.18,3632.07,0.0418480973444
695,2019-02-14,3631.17,3646.26,3607.70,3616.88,3616.88,6271044418,BTC,81.9542859108422500000,3549.909333,0.01886545844352696,-1,158928938965,3457.79,3616.88,0.0460091561373
696,2019-02-15,3617.37,3647.80,3608.21,3620.81,3620.81,6091952231,BTC,79.5791483214090000000,3560.777333,0.01685942741873773,1,165020891196,3487.95,3620.81,0.0380911423616
697,2019-02-16,3615.27,3652.84,3615.27,3629.79,3629.79,5934744052,BTC,77.5376651073197500000,3570.233333,0.01668144948665180,1,170955635248,3521.06,3629.79,0.0308799054830
698,2019-02-17,3633.36,3680.54,3619.18,3673.84,3673.84,7039512503,BTC,81.1296092460097500000,3580.418667,0.02609229302177582,1,177995147751,3464.01,3673.84,0.0605743055014
699,2019-02-18,3671.37,3936.67,3669.98,3915.71,3915.71,9908216640,BTC,87.4337850853052500000,3610.532000,0.08452438587997558,1,187903364391,3459.15,3915.71,0.1319861815764
700,2019-02-19,3911.66,4010.88,3908.15,3947.09,3947.09,9933626655,BTC,93.4000068794715000000,3643.061333,0.08345417197509477,1,197836991046,3466.36,3947.09,0.1386843836186
701,2019-02-20,3946.69,4000.49,3926.25,3999.82,3999.82,8693373948,BTC,98.5940079801870000000,3678.625333,0.08731377564294069,1,206530364994,3413.77,3999.82,0.1716723739443
702,2019-02-21,4000.26,4010.01,3940.11,3954.12,3954.12,7775128102,BTC,98.0969434496542500000,3714.648667,0.06446675162779264,-1,198755236892,3399.47,3954.12,0.1631577863608
703,2019-02-22,3952.41,4006.54,3950.82,4005.53,4005.53,7826525254,BTC,98.0969434496542500000,3755.052667,0.06670407986583907,1,206581762146,3666.78,4005.53,0.0923835081461
704,2019-02-23,3998.92,4166.29,3968.73,4142.53,4142.53,8922258316,BTC,98.0969434496542500000,3786.769333,0.09394833318726467,1,215504020462,3671.20,4142.53,0.1283858139028
705,2019-02-24,4145.46,4210.64,3793.71,3810.43,3810.43,10794227451,BTC,82.3022131157820000000,3796.051333,0.00378779572209752,-1,204709793011,3690.19,3810.43,0.0325836881028
706,2019-02-25,3807.00,3913.71,3807.00,3882.70,3882.70,9318796067,BTC,71.8477123561305000000,3808.885333,0.01937959810983892,1,214028589078,3648.43,3882.70,0.0642111812478
707,2019-02-26,3878.70,3891.58,3837.99,3854.36,3854.36,7931218996,BTC,58.1423000095120000000,3822.614000,0.00830478829408358,-1,206097370082,3653.53,3854.36,0.0549687562440
708,2019-02-27,3857.48,3888.80,3787.06,3851.05,3851.05,8301309684,BTC,44.2794635213545000000,3835.782000,0.00398041390256276,-1,197796060398,3632.07,3851.05,0.0602906882301
709,2019-02-28,3848.26,3906.06,3845.82,3854.79,3854.79,8399767798,BTC,46.3892323789592500000,3850.630000,0.00108034269716903,1,206195828196,3616.88,3854.79,0.0657776868461
710,2019-03-01,3853.76,3907.80,3851.69,3859.58,3859.58,7661247975,BTC,45.1882717099640000000,3866.810000,-0.00186975827620183,1,213857076171,3620.81,3859.58,0.0659438081534
711,2019-03-02,3855.32,3874.61,3832.13,3864.42,3864.42,7578786076,BTC,45.3336926379297500000,3883.050667,-0.00479794589298878,1,221435862247,3629.79,3864.42,0.0646401031465
712,2019-03-03,3862.27,3875.48,3836.91,3847.18,3847.18,7253558152,BTC,43.4425126119735000000,3897.543333,-0.01292181476818490,-1,214182304095,3673.84,3847.18,0.0471822398362
713,2019-03-04,3845.09,3867.38,3733.75,3761.56,3761.56,9029175788,BTC,32.1274740882410000000,3903.391333,-0.03633541218399790,-1,205153128307,3915.71,3761.56,-0.0393670624229
714,2019-03-05,3759.83,3903.92,3745.18,3896.38,3896.38,10174126415,BTC,29.5331453863925000000,3902.102667,-0.00146655982386022,1,215327254722,3947.09,3896.38,-0.0128474395061
715,2019-03-06,3897.08,3919.51,3871.46,3903.94,3903.94,9175291529,BTC,27.4363921794842500000,3899.226000,0.00120895788035882,1,224502546251,3999.82,3903.94,-0.0239710786985
716,2019-03-07,3903.38,3939.37,3894.11,3911.48,3911.48,9584165519,BTC,28.0284536840172500000,3893.336667,0.00466009866390011,1,234086711770,3954.12,3911.48,-0.0107836889118
717,2019-03-08,3913.23,3950.43,3875.23,3901.13,3901.13,10638638944,BTC,37.1873113368507500000,3889.804000,0.00291171483190413,-1,223448072826,4005.53,3901.13,-0.0260639665662
718,2019-03-09,3894.55,3987.24,3892.39,3963.31,3963.31,10796103518,BTC,41.5793894532377500000,3886.989333,0.01963490518279742,1,234244176344,4142.53,3963.31,-0.0432634163180
719,2019-03-10,3966.17,3966.17,3924.38,3951.60,3951.60,9713267607,BTC,55.7850807950317500000,3874.260667,0.01996234627647990,-1,224530908737,3810.43,3951.60,0.0370483121328
720,2019-03-11,3953.74,3966.38,3889.24,3905.23,3905.23,10125901903,BTC,63.7500097823077500000,3880.580667,0.00635197026301116,-1,214405006834,3882.70,3905.23,0.0058026630953
721,2019-03-12,3903.76,3926.89,3863.56,3909.16,3909.16,9809887079,BTC,72.8811149547530000000,3882.344667,0.00690699443249612,1,224214893913,3854.36,3909.16,0.0142176651896
722,2019-03-13,3913.05,3926.60,3891.90,3906.72,3906.72,9469184841,BTC,77.6294919454772500000,3885.835333,0.00537456305022486,-1,214745709072,3851.05,3906.72,0.0144557977694
723,2019-03-14,3905.58,3946.50,3901.30,3924.37,3924.37,10480789570,BTC,74.2552664188352500000,3890.723333,0.00864792073870137,1,225226498642,3854.79,3924.37,0.0180502699239
724,2019-03-15,3926.66,3968.54,3914.02,3960.91,3960.91,9394210605,BTC,81.1548946716232500000,3897.798000,0.01619170618898157,1,234620709247,3859.58,3960.91,0.0262541520062
725,2019-03-16,3963.90,4077.04,3961.66,4048.73,4048.73,9856166973,BTC,87.8649318463445000000,3910.408000,0.03537277951559019,1,244476876220,3864.42,4048.73,0.0476940912220
726,2019-03-17,4047.72,4054.12,4006.41,4025.23,4025.23,8221625400,BTC,92.8314969061627500000,3921.128667,0.02654881842468242,-1,236255250820,3847.18,4025.23,0.0462806523220
727,2019-03-18,4029.97,4071.56,4009.12,4032.51,4032.51,9646954186,BTC,96.2447201397357500000,3933.484000,0.02517513735914523,1,245902205006,3761.56,4032.51,0.0720312848924
728,2019-03-19,4032.69,4082.22,4023.81,4071.19,4071.19,9344919956,BTC,96.5421179092525000000,3954.126000,0.02960553103264792,1,255247124962,3896.38,4071.19,0.0448647205868
729,2019-03-20,4070.79,4089.46,4031.11,4087.48,4087.48,10175916388,BTC,96.5421179092525000000,3966.866000,0.03040536282294386,1,265423041350,3903.94,4087.48,0.0470140422240
730,2019-03-21,4083.95,4097.36,4005.15,4029.33,4029.33,10831212662,BTC,90.7867638489757500000,3975.225333,0.01361046543723060,-1,254591828688,3911.48,4029.33,0.0301292605357
731,2019-03-22,4028.51,4053.91,4021.54,4023.97,4023.97,9252935969,BTC,83.6785618459887500000,3982.724667,0.01035605934343138,-1,245338892719,3901.13,4023.97,0.0314883123608
732,2019-03-23,4022.71,4049.88,4015.96,4035.83,4035.83,9578850549,BTC,76.5935138350147500000,3991.704667,0.01105425793766521,1,254917743268,3963.31,4035.83,0.0182978369090
733,2019-03-24,4035.16,4040.70,4006.19,4022.17,4022.17,9144851065,BTC,67.6346660983892500000,3995.628667,0.00664259249594577,-1,245772892203,3951.60,4022.17,0.0178585889260
734,2019-03-25,4024.11,4038.84,3934.03,3963.07,3963.07,10359818883,BTC,58.3700030511782500000,3996.393333,-0.00833835166444564,-1,235413073320,3905.23,3963.07,0.0148109074241
735,2019-03-26,3969.23,3985.08,3944.75,3985.08,3985.08,10707678815,BTC,52.7278353156660000000,4001.716667,-0.00415738253964695,1,246120752135,3909.16,3985.08,0.0194210520930
736,2019-03-27,3984.24,4087.07,3977.81,4087.07,4087.07,10897131934,BTC,59.7561783034047500000,4013.577333,0.01831101306949702,1,257017884069,3906.72,4087.07,0.0461640455420
737,2019-03-28,4087.58,4094.90,4040.27,4069.11,4069.11,9353915899,BTC,65.8994414652035000000,4024.403333,0.01110889324472190,-1,247663968170,3924.37,4069.11,0.0368823530911
738,2019-03-29,4068.30,4113.50,4034.10,4098.37,4098.37,10918665557,BTC,82.9652850866027500000,4036.003333,0.01545258064830245,1,258582633727,3960.91,4098.37,0.0347041462694
739,2019-03-30,4092.14,4296.81,4053.91,4106.66,4106.66,9732688060,BTC,97.1277104019380000000,4045.720000,0.01506283183215843,1,268315321787,4048.73,4106.66,0.0143081904696
740,2019-03-31,4105.46,4113.02,4094.10,4105.40,4105.40,9045122443,BTC,96.9650408169135000000,4049.498000,0.01380467406083421,-1,259270199344,4025.23,4105.40,0.0199168743153
741,2019-04-01,4105.36,4164.95,4096.90,4158.18,4158.18,10157794171,BTC,99.7806253917402500000,4058.361333,0.02459580574759039,1,269427993515,4032.51,4158.18,0.0311642128600
742,2019-04-02,4156.92,4905.95,4155.32,4879.88,4879.88,21315047816,BTC,99.7806253917402500000,4114.852667,0.18591852367772758,1,290743041331,4071.19,4879.88,0.1986372534812
743,2019-04-03,4879.96,5307.00,4876.62,4973.02,4973.02,22899891582,BTC,99.7806253917402500000,4174.974667,0.19114974260992324,1,313642932913,4087.48,4973.02,0.2166469316058
744,2019-04-04,4971.31,5063.16,4836.79,4922.80,4922.80,18251810240,BTC,98.7568691519382500000,4230.662667,0.16360021762047047,-1,295391122673,4029.33,4922.80,0.2217415798656
745,2019-04-05,4922.81,5053.51,4919.49,5036.68,5036.68,16837325387,BTC,98.7568691519382500000,4297.819333,0.17191524579146380,1,312228448060,4023.97,5036.68,0.2516693712925
746,2019-04-06,5036.79,5205.82,4992.22,5059.82,5059.82,16929795194,BTC,98.7568691519382500000,4366.876000,0.15868185861013686,1,329158243254,4035.83,5059.82,0.2537247604582
747,2019-04-07,5062.79,5235.19,5050.41,5198.90,5198.90,16655416140,BTC,98.7568691519382500000,4444.414000,0.16976051285951309,1,345813659394,4022.17,5198.90,0.2925609807641
748,2019-04-08,5199.84,5318.84,5148.21,5289.77,5289.77,17154113634,BTC,100.0000000000000000000,4528.920667,0.16799793790691278,1,362967773028,3963.07,5289.77,0.3347657245519
749,2019-04-09,5289.92,5289.92,5167.42,5204.96,5204.96,14722104361,BTC,98.3749013175542500000,4611.713333,0.12863910311920509,-1,348245668667,3985.08,5204.96,0.3061117970028
750,2019-04-10,5204.11,5421.65,5193.38,5324.55,5324.55,15504590933,BTC,98.3749013175542500000,4701.011333,0.13263926054015322,1,363750259600,4087.07,5324.55,0.3027792526186
751,2019-04-11,5325.08,5354.23,5017.30,5064.49,5064.49,16555616019,BTC,93.1962388565845000000,4766.172667,0.06259054252597433,-1,347194643581,4069.11,5064.49,0.2446186021022
752,2019-04-12,5061.20,5103.27,4955.85,5089.54,5089.54,13675206312,BTC,88.4047319000202500000,4834.201333,0.05281920412726013,1,360869849893,4098.37,5089.54,0.2418449285936
753,2019-04-13,5088.85,5127.12,5061.59,5096.59,5096.59,10823289598,BTC,85.3552622356670000000,4900.749333,0.03996137196433915,1,371693139491,4106.66,5096.59,0.2410547744396
754,2019-04-14,5095.76,5184.02,5053.57,5167.72,5167.72,10391952498,BTC,82.1392920925345000000,4971.486667,0.03947176089248476,1,382085091989,4105.40,5167.72,0.2587616310226
755,2019-04-15,5167.32,5196.61,5024.07,5067.11,5067.11,12290155061,BTC,81.7999799828277500000,5035.600667,0.00625731369178882,-1,369794936928,4158.18,5067.11,0.2185884208957
756,2019-04-16,5066.58,5238.95,5055.19,5235.56,5235.56,11618660197,BTC,81.5883385372060000000,5107.426000,0.02508778394439782,1,381413597125,4879.88,5235.56,0.0728870382059
757,2019-04-17,5236.14,5274.28,5219.21,5251.94,5251.94,12438480677,BTC,81.7445496966995000000,5132.230000,0.02332514326131136,1,393852077802,4973.02,5251.94,0.0560866435285
758,2019-04-18,5251.48,5319.99,5250.51,5298.39,5298.39,13256489918,BTC,83.3326418062290000000,5153.921333,0.02803082500987797,1,407108567720,4922.80,5298.39,0.0762960104006
759,2019-04-19,5298.15,5336.68,5233.33,5303.81,5303.81,13780238655,BTC,87.0494561309612500000,5179.322000,0.02403557840196072,1,420888806375,5036.68,5303.81,0.0530369211465
760,2019-04-20,5304.16,5358.49,5295.88,5337.89,5337.89,13169647522,BTC,92.0526045331472500000,5199.402667,0.02663523905908709,1,434058453897,5059.82,5337.89,0.0549565004289
761,2019-04-21,5335.88,5359.92,5257.34,5314.53,5314.53,13731844223,BTC,94.4348973459100000000,5216.383333,0.01881507947836241,-1,420326609674,5198.90,5314.53,0.0222412433399
762,2019-04-22,5312.49,5422.69,5280.28,5399.37,5399.37,14601631648,BTC,96.0627753795130000000,5229.748000,0.03243406756883888,1,434928241322,5289.77,5399.37,0.0207192373203
763,2019-04-23,5399.37,5633.80,5389.41,5572.36,5572.36,15867308108,BTC,97.8639356254572500000,5248.587333,0.06168758305007326,1,450795549430,5204.96,5572.36,0.0705865174756
764,2019-04-24,5571.51,5642.04,5418.26,5464.87,5464.87,17048033399,BTC,92.5727193693287500000,5265.914667,0.03778172370448706,-1,433747516031,5324.55,5464.87,0.0263534007569
765,2019-04-25,5466.52,5542.24,5181.34,5210.52,5210.52,15330283408,BTC,76.8971390316420000000,5258.312667,-0.00908897397827561,-1,418417232623,5064.49,5210.52,0.0288340978065
766,2019-04-26,5210.30,5383.63,5177.37,5279.35,5279.35,16812108040,BTC,62.3988708475747500000,5272.636667,0.00127324020674835,1,435229340663,5089.54,5279.35,0.0372941366017
767,2019-04-27,5279.47,5310.75,5233.64,5268.29,5268.29,13111274675,BTC,47.3533488287722500000,5284.553333,-0.00307752272996125,-1,422118065988,5096.59,5268.29,0.0336891921854
768,2019-04-28,5271.75,5326.23,5255.68,5285.14,5285.14,12819992056,BTC,38.4327887365582500000,5297.123333,-0.00226223409323817,1,434938058044,5167.72,5285.14,0.0227218192936
769,2019-04-29,5284.86,5311.27,5216.49,5247.35,5247.35,13735490672,BTC,40.1627906976745000000,5302.432000,-0.01038806343956886,-1,421202567372,5067.11,5247.35,0.0355705717855
770,2019-04-30,5247.73,5363.26,5224.19,5350.73,5350.73,13878964574,BTC,39.3483516078085000000,5321.340000,0.00552304494732530,1,435081531946,5235.56,5350.73,0.0219976468611
771,2019-05-01,5350.91,5418.00,5347.65,5402.70,5402.70,13679528236,BTC,42.6718417893347500000,5332.482667,0.01316785020878531,1,448761060182,5251.94,5402.70,0.0287055830798
772,2019-05-02,5402.42,5522.26,5394.22,5505.28,5505.28,14644460907,BTC,52.2489729906510000000,5349.372000,0.02914510338783693,1,463405521089,5298.39,5505.28,0.0390477107197
773,2019-05-03,5505.55,5865.88,5490.20,5768.29,5768.29,18720780006,BTC,68.3306157417642500000,5380.698667,0.07203364413939592,1,482126301095,5303.81,5768.29,0.0875747811479
774,2019-05-04,5769.20,5886.89,5645.47,5831.17,5831.17,17567780766,BTC,83.6433230156975000000,5415.856000,0.07668483061588048,1,499694081861,5337.89,5831.17,0.0924110463123
775,2019-05-05,5831.07,5833.86,5708.04,5795.71,5795.71,14808830723,BTC,93.9370135978380000000,5446.377333,0.06414037178132476,-1,484885251138,5314.53,5795.71,0.0905404617153
776,2019-05-06,5791.69,5802.96,5653.69,5746.81,5746.81,15737171804,BTC,95.1736083138645000000,5475.196000,0.04960808708948502,-1,469148079334,5399.37,5746.81,0.0643482480363
777,2019-05-07,5745.60,5988.18,5741.40,5829.50,5829.50,18026409033,BTC,95.1063401272860000000,5503.871333,0.05916356820472932,1,487174488367,5572.36,5829.50,0.0461456187325
778,2019-05-08,5849.48,5989.98,5794.72,5982.46,5982.46,15320605300,BTC,95.1063401272860000000,5531.211333,0.08158225022207807,1,502495093667,5464.87,5982.46,0.0947122255424
779,2019-05-09,5982.32,6183.04,5982.32,6174.53,6174.53,16784645411,BTC,96.5346813824217500000,5578.522000,0.10683976866990934,1,519279739078,5210.52,6174.53,0.1850122444593
780,2019-05-10,6175.82,6434.62,6161.52,6378.85,6378.85,19419875368,BTC,99.9327318134215000000,5656.410667,0.12772045304538706,1,538699614446,5279.35,6378.85,0.2082642749581
781,2019-05-11,6379.67,7333.00,6375.70,7204.77,7204.77,28867562329,BTC,100.0000000000000000000,5784.772000,0.24547173164301030,1,567567176775,5268.29,7204.77,0.3675727797824
782,2019-05-12,7203.51,7503.87,6815.77,6972.37,6972.37,27773333680,BTC,97.0318071747505000000,5898.377333,0.18208273332926156,-1,539793843095,5285.14,6972.37,0.3192403607095
783,2019-05-13,6971.18,8047.41,6898.28,7814.92,7814.92,28677672181,BTC,97.0318071747505000000,6067.029333,0.28809662374513527,1,568471515276,5247.35,7814.92,0.4893079363869
784,2019-05-14,7807.88,8268.71,7696.39,7994.42,7994.42,32031452227,BTC,97.0318071747505000000,6250.167333,0.27907295502163478,1,600502967503,5350.73,7994.42,0.4940802469943
785,2019-05-15,7989.37,8216.42,7899.11,8205.17,8205.17,28344112920,BTC,97.0318071747505000000,6440.463333,0.27400306092232511,1,628847080423,5402.70,8205.17,0.5187165676421
786,2019-05-16,8194.50,8320.82,7729.61,7884.91,7884.91,33167197581,BTC,97.0345088133220000000,6605.944000,0.19360836240815847,-1,595679882842,5505.28,7884.91,0.4322450447570
787,2019-05-17,7886.93,7929.15,7038.12,7343.90,7343.90,30066644905,BTC,88.2759258555777500000,6728.518667,0.09145866474564988,-1,565613237937,5768.29,7343.90,0.2731502750382
788,2019-05-18,7341.66,7447.27,7251.50,7271.21,7271.21,21354286562,BTC,78.7781305774247500000,6828.713333,0.06479942053821752,-1,544258951375,5831.17,7271.21,0.2469555852428
789,2019-05-19,7267.96,8261.94,7267.96,8197.69,8197.69,25902422040,BTC,78.7020636059477500000,6986.481333,0.17336461793420496,1,570161373415,5795.71,8197.69,0.4144410262073
790,2019-05-20,8196.92,8200.97,7678.78,7978.31,7978.31,23843404340,BTC,79.3605289705330000000,7131.988000,0.11866565114803895,-1,546317969075,5746.81,7978.31,0.3883023799290
791,2019-05-21,7977.97,8062.17,7843.34,7963.33,7963.33,25127245056,BTC,85.5741456661280000000,7279.756000,0.09390067469294301,-1,521190724019,5829.50,7963.33,0.3660399691226
792,2019-05-22,7956.29,7997.61,7615.99,7680.07,7680.07,24719473175,BTC,89.1658623285372500000,7403.127333,0.03740887526890252,-1,496471250844,5982.46,7680.07,0.2837645383337
793,2019-05-23,7677.27,7943.79,7533.20,7881.85,7881.85,24457107820,BTC,85.2614108427790000000,7529.753333,0.04676071730755061,1,520928358664,6174.53,7881.85,0.2765101149399
794,2019-05-24,7881.70,8140.72,7824.45,7987.37,7987.37,25919126991,BTC,84.5870314346820000000,7650.609333,0.04401749616823625,1,546847485655,6378.85,7987.37,0.2521645751193
795,2019-05-25,7991.89,8117.93,7965.98,8052.54,8052.54,22256813107,BTC,84.0368078850207500000,7762.188667,0.03740585876692141,1,569104298762,7204.77,8052.54,0.1176678783639
796,2019-05-26,8055.21,8687.52,7924.67,8673.22,8673.22,26677970091,BTC,89.9428865007645000000,7860.085333,0.10345112458081249,1,595782268853,6972.37,8673.22,0.2439414431535
797,2019-05-27,8674.07,8907.17,8668.71,8805.78,8805.78,27949839564,BTC,93.9234049579997500000,7982.312667,0.10316149809620080,1,623732108417,7814.92,8805.78,0.1267908052802
798,2019-05-28,8802.76,8807.02,8634.72,8719.96,8719.96,24226919267,BTC,95.5066986650917500000,8042.648667,0.08421495965366406,-1,599505189150,7994.42,8719.96,0.0907558021720
799,2019-05-29,8718.59,8755.85,8482.73,8659.49,8659.49,23473479966,BTC,96.2186475690257500000,8086.986667,0.07079315900645345,-1,576031709184,8205.17,8659.49,0.0553699679592
800,2019-05-30,8661.76,9008.31,8221.27,8319.47,8319.47,29246528551,BTC,88.2960699088342500000,8094.606667,0.02777940204515684,-1,546785180633,7884.91,8319.47,0.0551128674899
801,2019-05-31,8320.29,8586.66,8172.55,8574.50,8574.50,25365190957,BTC,84.5282391810082500000,8140.579333,0.05330341358396783,1,572150371590,7343.90,8574.50,0.1675676411716
802,2019-06-01,8573.84,8625.60,8481.58,8564.02,8564.02,22488303544,BTC,81.9877881100242500000,8221.920667,0.04160820164235720,-1,549662068046,7271.21,8564.02,0.1777984682054
803,2019-06-02,8565.47,8809.30,8561.24,8742.96,8742.96,20266216022,BTC,82.9759094933340000000,8320.037333,0.05083182323263741,1,569928284068,8197.69,8742.96,0.0665150792479
804,2019-06-03,8741.75,8743.50,8204.19,8209.00,8209.00,22004511436,BTC,77.6450737522055000000,8320.791333,-0.01343518044451362,-1,547923772632,7978.31,8209.00,0.0289146448308
805,2019-06-04,8210.99,8210.99,7564.49,7707.77,7707.77,24609731549,BTC,57.0280717966582500000,8302.755333,-0.07166119066946134,-1,523314041083,7963.33,7707.77,-0.0320921021733
806,2019-06-05,7704.34,7901.85,7668.67,7824.23,7824.23,21760923463,BTC,39.1681694219647500000,8293.482000,-0.05658081852712769,1,545074964546,7680.07,7824.23,0.0187706622466
807,2019-06-06,7819.63,7937.34,7571.47,7822.02,7822.02,19474611077,BTC,18.1645858381810000000,8302.945333,-0.05792225694761177,1,564549575623,7881.85,7822.02,-0.0075908574764
808,2019-06-07,7826.90,8126.15,7788.37,8043.95,8043.95,19141423231,BTC,14.0723011128902500000,8313.752000,-0.03245249557600467,1,583690998854,7987.37,8043.95,0.0070836833651
809,2019-06-08,8036.77,8076.89,7837.61,7954.13,7954.13,16522722810,BTC,19.0663723277887500000,8311.536000,-0.04300119737194184,-1,567168276044,8052.54,7954.13,-0.0122209886570
810,2019-06-09,7949.67,7975.97,7583.22,7688.08,7688.08,16610726547,BTC,15.8648372965640000000,8287.238667,-0.07229895156584127,-1,550557549497,8673.22,7688.08,-0.1135841129361
811,2019-06-10,7692.28,8031.91,7586.73,8000.33,8000.33,18689275117,BTC,20.2477490476630000000,8242.379333,-0.02936643937641980,1,569246824614,8805.78,8000.33,-0.0914683310280
812,2019-06-11,8004.24,8026.39,7772.80,7927.71,7927.71,17107279932,BTC,18.2725291551625000000,8183.841333,-0.03129720171469996,-1,552139544682,8719.96,7927.71,-0.0908547745632
813,2019-06-12,7925.43,8196.65,7862.36,8145.86,8145.86,19034432883,BTC,23.5123919432185000000,8145.568000,0.00003584771497826,1,571173977565,8659.49,8145.86,-0.0593141166512
814,2019-06-13,8145.55,8311.57,8087.06,8230.92,8230.92,18669407147,BTC,36.3773623663945000000,8116.996667,0.01403515828251602,1,589843384712,8319.47,8230.92,-0.0106437068708
815,2019-06-14,8230.90,8710.64,8183.39,8693.83,8693.83,19831162906,BTC,53.2288032762017500000,8141.954000,0.06778176344400865,1,609674547618,8574.50,8693.83,0.0139168464634
816,2019-06-15,8689.75,8859.13,8618.40,8838.38,8838.38,18371033226,BTC,72.5497212953130000000,8159.546000,0.08319506992178241,1,628045580844,8564.02,8838.38,0.0320363567577
817,2019-06-16,8841.44,9335.87,8814.56,8994.49,8994.49,23348550311,BTC,86.7006199757317500000,8188.244000,0.09846384646085290,1,651394131155,8742.96,8994.49,0.0287694327779
818,2019-06-17,8988.92,9416.41,8988.92,9320.35,9320.35,15562951919,BTC,98.8356495525557500000,8226.736667,0.13293403900805811,1,666957083074,8209.00,9320.35,0.1353818979169
819,2019-06-18,9335.47,9348.37,9004.90,9081.76,9081.76,15848210536,BTC,96.3457332426620000000,8284.920667,0.09617947654875233,-1,651108872538,7707.77,9081.76,0.1782603788125
820,2019-06-19,9078.73,9299.62,9070.40,9273.52,9273.52,15546809946,BTC,95.6284805822565000000,8389.304000,0.10539801633127134,1,666655682484,7824.23,9273.52,0.1852310067572
821,2019-06-20,9273.06,9594.42,9232.48,9527.16,9527.16,17846823784,BTC,95.6284805822565000000,8502.832667,0.12046895112677865,1,684502506268,7822.02,9527.16,0.2179922833232
822,2019-06-21,9525.07,10144.56,9525.07,10144.56,10144.56,20624008643,BTC,95.6284805822565000000,8657.668667,0.17174269311870398,1,705126514911,8043.95,10144.56,0.2611416033168
823,2019-06-22,10175.92,11157.35,10107.04,10701.69,10701.69,29995204861,BTC,99.2827473395945000000,8834.851333,0.21130391408251216,1,735121719772,7954.13,10701.69,0.3454255839419
824,2019-06-23,10696.69,11246.14,10556.10,10855.37,10855.37,20998326502,BTC,100.0000000000000000000,9028.267333,0.20237578259580320,1,756120046274,7688.08,10855.37,0.4119741209769
825,2019-06-24,10853.74,11065.90,10610.43,11011.10,11011.10,19271652365,BTC,100.0000000000000000000,9249.802000,0.19041467049781174,1,775391698639,8000.33,11011.10,0.3763307263575
826,2019-06-25,11007.20,11790.92,11007.20,11790.92,11790.92,24879684533,BTC,100.0000000000000000000,9502.508000,0.24082189670348081,1,800271383172,7927.71,11790.92,0.4873046567041
827,2019-06-26,11778.58,13796.49,11755.60,13016.23,13016.23,45105733173,BTC,100.0000000000000000000,9841.742667,0.32255337701972857,1,845377116345,8145.86,13016.23,0.5978951270952
828,2019-06-27,13017.13,13311.14,10491.85,11182.81,11182.81,39977475223,BTC,90.4216236774630000000,10044.206000,0.11335928394937340,-1,805399641122,8230.92,11182.81,0.3586342717461
829,2019-06-28,11162.17,12445.17,10914.50,12407.33,12407.33,35087757766,BTC,86.8998533646737500000,10322.633333,0.20195395881548164,1,840487398888,8693.83,12407.33,0.4271420076077
830,2019-06-29,12400.76,12400.91,11508.38,11959.37,11959.37,29923961128,BTC,80.5756674795892500000,10540.336000,0.13462891505545933,-1,810563437760,8838.38,11959.37,0.3531178790683
831,2019-06-30,11931.99,12178.38,10799.01,10817.16,10817.16,27256473494,BTC,66.9057758406470000000,10672.254667,0.01357776191830075,-1,783306964266,8994.49,10817.16,0.2026429514069
832,2019-07-01,10796.93,11206.44,10089.31,10583.13,10583.13,29378589324,BTC,61.0240012406962500000,10778.164000,-0.01809528969869080,-1,753928374942,9320.35,10583.13,0.1354863283031
833,2019-07-02,10588.68,10912.19,9737.88,10801.68,10801.68,31015895223,BTC,50.4743083068475000000,10876.919333,-0.00691733851254443,1,784944270165,9081.76,10801.68,0.1893817938373
834,2019-07-03,10818.16,11968.08,10818.16,11961.27,11961.27,30796494294,BTC,49.7517286129797500000,11068.886667,0.08062087541834617,1,815740764459,9273.52,11961.27,0.2898306144808
835,2019-07-04,11972.72,12006.08,11166.57,11215.44,11215.44,25920294033,BTC,50.5185400614987500000,11198.348000,0.00152629655731363,-1,789820470426,9527.16,11215.44,0.1772070585568
836,2019-07-05,11203.10,11395.66,10874.96,10978.46,10978.46,23838480210,BTC,48.2384039732922500000,11295.101333,-0.02803350971937668,-1,765981990216,10144.56,10978.46,0.0822016923356
837,2019-07-06,10982.54,11620.96,10982.54,11208.55,11208.55,21092024306,BTC,43.7360313726572500000,11366.034000,-0.01385566856477818,1,787074014522,10701.69,11208.55,0.0473626128210
838,2019-07-07,11217.62,11541.62,11148.80,11450.85,11450.85,19369044277,BTC,34.6985833968850000000,11415.978000,0.00305466601284621,1,806443058799,10855.37,11450.85,0.0548557994799
839,2019-07-08,11446.60,12345.83,11393.37,12285.96,12285.96,23482551458,BTC,40.0981701016315000000,11511.350667,0.06729091619288432,1,829925610257,11011.10,12285.96,0.1157795315636
840,2019-07-09,12284.33,12779.13,12233.26,12573.81,12573.81,28167921523,BTC,53.2926102502980000000,11615.531333,0.08249977030990460,1,858093531780,11790.92,12573.81,0.0663977026390
841,2019-07-10,12571.54,13129.53,11710.98,12156.51,12156.51,33627574244,BTC,63.0328593152767500000,11639.904000,0.04438232480267878,-1,824465957536,13016.23,12156.51,-0.0660498469987
842,2019-07-11,12139.71,12144.62,11158.92,11358.66,11358.66,28595327690,BTC,63.8565839918290000000,11529.399333,-0.01480903974861047,-1,795870629846,11182.81,11358.66,0.0157250279670
843,2019-07-12,11354.30,11905.49,11179.14,11815.99,11815.99,23534692797,BTC,61.8429777929757500000,11571.611333,0.02111881050680291,1,819405322643,12407.33,11815.99,-0.0476605361508
844,2019-07-13,11813.13,11841.96,10908.48,11392.38,11392.38,21042616384,BTC,51.5518091628100000000,11503.948000,-0.00969823577088492,-1,798362706259,11959.37,11392.38,-0.0474096879685
845,2019-07-14,11381.02,11451.20,10234.58,10256.06,10256.06,22486000001,BTC,35.3853959451042500000,11390.394000,-0.09958689752084081,-1,775876706258,10817.16,10256.06,-0.0518712859937
846,2019-07-15,10257.84,11052.77,9992.01,10895.09,10895.09,25384047207,BTC,32.5386687732280000000,11395.589333,-0.04392044310956568,1,801260753465,10583.13,10895.09,0.0294771017648
847,2019-07-16,10896.65,10996.63,9448.11,9477.64,9477.64,24151199070,BTC,17.0557684577580000000,11321.890000,-0.16289241460568863,-1,777109554395,10801.68,9477.64,-0.1225772287274
848,2019-07-17,9471.21,9963.13,9163.13,9693.80,9693.80,24569921549,BTC,8.6381661479575000000,11248.031333,-0.13817807641059138,1,801679475944,11961.27,9693.80,-0.1895676629656
849,2019-07-18,9698.50,10736.84,9376.80,10666.48,10666.48,25187024648,BTC,18.2374452573087500000,11161.712000,-0.04436882084038721,1,826866500592,11215.44,10666.48,-0.0489468090418
850,2019-07-19,10653.96,10716.98,10229.63,10530.73,10530.73,20727426310,BTC,19.8478281231327500000,11116.064667,-0.05265664464310551,-1,806139074282,10978.46,10530.73,-0.0407825869931
851,2019-07-20,10525.82,11048.66,10451.28,10767.14,10767.14,20206615155,BTC,30.2598856005967500000,11101.976667,-0.03016009464290113,1,826345689437,11208.55,10767.14,-0.0393815435538
852,2019-07-21,10777.53,10841.89,10389.60,10599.11,10599.11,17130580467,BTC,37.5698039836312500000,11061.347333,-0.04178851988681151,-1,809215108970,11450.85,10599.11,-0.0743822510993
853,2019-07-22,10596.95,10651.79,10154.92,10343.11,10343.11,16334414913,BTC,34.9587554946917500000,10987.498000,-0.05864738268894338,-1,792880694057,12285.96,10343.11,-0.1581357907726
854,2019-07-23,10346.75,10346.75,9883.59,9900.77,9900.77,17851916995,BTC,29.8721484931382500000,10828.485333,-0.08567360110585099,-1,775028777062,12573.81,9900.77,-0.2125879109037
855,2019-07-24,9887.73,9908.80,9614.31,9811.93,9811.93,17398734322,BTC,22.5797832739772500000,10644.360000,-0.07820385631451774,-1,757630042740,12156.51,9811.93,-0.1928662091340
856,2019-07-25,9809.10,10154.25,9773.96,9911.84,9911.84,15821952090,BTC,18.1666449013315000000,10494.715333,-0.05553988979264484,1,773451994830,11358.66,9911.84,-0.1273759404719
857,2019-07-26,9913.13,9916.52,9717.98,9870.30,9870.30,14495714483,BTC,15.3764599113857500000,10395.491333,-0.05052106881497796,-1,758956280347,11815.99,9870.30,-0.1646658468736
858,2019-07-27,9871.17,10167.32,9411.52,9477.68,9477.68,16817809536,BTC,11.9604223612832500000,10239.604000,-0.07440951818058589,-1,742138470811,11392.38,9477.68,-0.1680684808618
859,2019-07-28,9491.63,9575.54,9252.30,9552.86,9552.86,13738687093,BTC,10.1674082926870000000,10116.969333,-0.05575872718719844,1,755877157904,10256.06,9552.86,-0.0685643414723
860,2019-07-29,9548.18,9681.65,9472.95,9519.15,9519.15,13791445323,BTC,6.2573706742250000000,10067.842000,-0.05449946473136944,-1,742085712581,10895.09,9519.15,-0.1262899159163
861,2019-07-30,9522.33,9701.76,9437.34,9607.42,9607.42,13829811132,BTC,4.5754165520955000000,9981.997333,-0.03752528882788472,1,755915523713,9477.64,9607.42,0.0136932822939
862,2019-07-31,9604.05,10085.63,9598.10,10085.63,10085.63,16631520648,BTC,16.3618050878457500000,10022.530000,0.00629581552761628,1,772547044361,9693.80,10085.63,0.0404206812602
863,2019-08-01,10077.44,10446.92,9922.02,10399.67,10399.67,17165337858,BTC,32.9106329239172500000,10069.588000,0.03278008991033198,1,789712382219,10666.48,10399.67,-0.0250138752428
864,2019-08-02,10402.04,10657.95,10371.01,10518.17,10518.17,17489094082,BTC,52.3514877207045000000,10059.700667,0.04557484841511935,1,807201476301,10530.73,10518.17,-0.0011926998413
865,2019-08-03,10519.28,10946.78,10503.50,10821.73,10821.73,15352685061,BTC,74.8353962123680000000,10079.100667,0.07368011864703802,1,822554161362,10767.14,10821.73,0.0050700557437
866,2019-08-04,10821.63,11009.21,10620.28,10970.18,10970.18,16530894787,BTC,88.0484854124982500000,10092.636667,0.08694886796720946,1,839085056149,10599.11,10970.18,0.0350095432541
867,2019-08-05,10960.74,11895.09,10960.74,11805.65,11805.65,23875988832,BTC,95.1729793867200000000,10173.072667,0.16048025866323048,1,862961044981,10343.11,11805.65,0.1414023441692
868,2019-08-06,11811.54,12273.82,11290.73,11478.17,11478.17,23635107660,BTC,96.4832021031200000000,10248.743333,0.11995877221760062,-1,839325937321,9900.77,11478.17,0.1593209417045
869,2019-08-07,11476.19,12036.99,11433.70,11941.97,11941.97,22194988641,BTC,96.4832021031200000000,10384.823333,0.14994445423561834,1,861520925962,9811.93,11941.97,0.2170867505170
870,2019-08-08,11954.04,11979.42,11556.17,11966.41,11966.41,19481591730,BTC,96.4832021031200000000,10528.455333,0.13657793299392440,1,881002517692,9911.84,11966.41,0.2072844194418
871,2019-08-09,11953.47,11970.46,11709.75,11862.94,11862.94,18339989960,BTC,95.4438165530602500000,10658.528667,0.11299977423047072,-1,862662527732,9870.30,11862.94,0.2018824149215
872,2019-08-10,11861.56,11915.66,11323.90,11354.02,11354.02,18125355447,BTC,92.8089828948900000000,10757.443333,0.05545710523707018,-1,844537172285,9477.68,11354.02,0.1979746098201
873,2019-08-11,11349.74,11523.58,11248.29,11523.58,11523.58,15774371518,BTC,88.2852502306042500000,10893.836667,0.05780730446488527,1,860311543803,9552.86,11523.58,0.2062963342915
874,2019-08-12,11528.19,11528.19,11320.95,11382.62,11382.62,13647198229,BTC,82.3215397952602500000,11015.820667,0.03329750402517151,-1,846664345574,9519.15,11382.62,0.1957601256415
875,2019-08-13,11385.05,11420.05,10830.33,10895.83,10895.83,16681503537,BTC,72.0151799203712500000,11107.599333,-0.01906526573846126,-1,829982842037,9607.42,10895.83,0.1341057224520
876,2019-08-14,10889.49,10889.56,10028.14,10051.70,10051.70,19990838300,BTC,53.1668114754215000000,11137.218000,-0.09746760815851858,-1,809992003737,10085.63,10051.70,-0.0033641924203
877,2019-08-15,10038.42,10437.41,9675.32,10311.55,10311.55,22899115082,BTC,36.0833555837380000000,11152.279333,-0.07538632309112374,1,832891118819,10399.67,10311.55,-0.0084733457889
878,2019-08-16,10319.42,10524.35,9855.48,10374.34,10374.34,20228207096,BTC,21.2597144097000000000,11150.590667,-0.06961520606233908,1,853119325915,10518.17,10374.34,-0.0136744319592
879,2019-08-17,10358.72,10452.63,10086.70,10231.74,10231.74,13778035685,BTC,9.9562074674495000000,11131.495333,-0.08082969143710820,-1,839341290230,10821.73,10231.74,-0.0545190094375
880,2019-08-18,10233.01,10487.07,10119.09,10345.81,10345.81,12999813869,BTC,13.7963451384285000000,11099.767333,-0.06792550784001195,1,852341104099,10970.18,10345.81,-0.0569152010268
881,2019-08-19,10350.28,10916.05,10313.20,10916.05,10916.05,16038264603,BTC,21.6891853074357500000,11096.158667,-0.01623162324955244,1,868379368702,11805.65,10916.05,-0.0753537501112
882,2019-08-20,10916.35,10947.04,10618.96,10763.23,10763.23,15053082175,BTC,26.7668471987925000000,11026.664000,-0.02389063455638079,-1,853326286527,11478.17,10763.23,-0.0622869324988
883,2019-08-21,10764.57,10798.73,9962.72,10138.05,10138.05,19473084768,BTC,25.5435548986530000000,10937.322667,-0.07307754295405026,-1,833853201759,11941.97,10138.05,-0.1510571538867
884,2019-08-22,10142.52,10233.00,9831.46,10131.06,10131.06,17097508856,BTC,22.7396054755027500000,10816.595333,-0.06337810668653957,-1,816755692903,11966.41,10131.06,-0.1533751559574
885,2019-08-23,10136.31,10442.44,10078.19,10407.96,10407.96,15627023886,BTC,16.3713033026272500000,10712.698667,-0.02844648920619173,1,832382716789,11862.94,10407.96,-0.1226491915158
886,2019-08-24,10407.64,10418.02,9982.30,10159.96,10159.96,15451030650,BTC,8.9197978145215000000,10599.166667,-0.04143784891763699,-1,816931686139,11354.02,10159.96,-0.1051662759093
887,2019-08-25,10160.74,10304.62,10008.79,10138.52,10138.52,14153856610,BTC,9.2669871539802500000,10518.133333,-0.03609132162348488,-1,802777829529,11523.58,10138.52,-0.1201935509625
888,2019-08-26,10126.30,10512.33,10126.30,10370.82,10370.82,18438654080,BTC,14.2251486792407500000,10441.282667,-0.00674846848296708,1,821216483609,11382.62,10370.82,-0.0888899040818
889,2019-08-27,10372.83,10381.33,10087.30,10185.50,10185.50,14762609503,BTC,13.1777593246917500000,10361.474667,-0.01698355423870864,-1,806453874106,10895.83,10185.50,-0.0651928306517
890,2019-08-28,10203.43,10279.37,9716.66,9754.42,9754.42,17603790323,BTC,11.3389545308227500000,10285.380667,-0.05162285035337137,-1,788850083783,10051.70,9754.42,-0.0295750967498
891,2019-08-29,9756.79,9756.79,9421.63,9510.20,9510.20,17045878501,BTC,9.8643098587027500000,10249.280667,-0.07211049155670468,-1,771804205282,10311.55,9510.20,-0.0777138257585
892,2019-08-30,9514.84,9656.12,9428.30,9598.17,9598.17,13595263986,BTC,5.4343161691217500000,10201.722000,-0.05916177680591571,1,785399469268,10374.34,9598.17,-0.0748163256651
893,2019-08-31,9597.54,9673.22,9531.80,9630.66,9630.66,11454806419,BTC,3.7064765088737500000,10152.143333,-0.05136682135927838,1,796854275687,10231.74,9630.66,-0.0587466061491
894,2019-09-01,9630.59,9796.76,9582.94,9757.97,9757.97,11445355859,BTC,8.1125297862505000000,10120.558667,-0.03582694186461159,1,808299631546,10345.81,9757.97,-0.0568191374093
895,2019-09-02,9757.47,10396.59,9730.65,10346.76,10346.76,17248102294,BTC,22.9889390760040000000,10120.622000,0.02234427883977882,1,825547733840,10916.05,10346.76,-0.0521516482610
896,2019-09-03,10345.73,10736.10,10308.55,10623.54,10623.54,19384917989,BTC,43.6375387876482500000,10101.121333,0.05171887850641661,1,844932651829,10763.23,10623.54,-0.0129784460613
897,2019-09-04,10621.18,10762.64,10434.71,10594.49,10594.49,16742664769,BTC,65.8431019090877500000,10089.872000,0.05001232919505817,-1,828189987060,10138.05,10594.49,0.0450224648724
898,2019-09-05,10588.18,10627.27,10516.42,10575.53,10575.53,14551239508,BTC,85.3589862248990000000,10119.037333,0.04511226236030332,-1,813638747552,10131.06,10575.53,0.0438720133925
899,2019-09-06,10578.20,10898.76,10292.30,10353.30,10353.30,19536574783,BTC,89.4143497987810000000,10133.853333,0.02165480985257516,-1,794102172769,10407.96,10353.30,-0.0052517496224
900,2019-09-07,10353.93,10558.67,10348.92,10517.25,10517.25,15307366476,BTC,89.8146567984620000000,10141.139333,0.03708761458154004,1,809409539245,10159.96,10517.25,0.0351664770334
901,2019-09-08,10518.11,10595.64,10409.09,10441.28,10441.28,13670567493,BTC,86.3743330878257500000,10159.894000,0.02769576139278618,-1,795738971752,10138.52,10441.28,0.0298623467725
902,2019-09-09,10443.23,10450.31,10144.93,10334.97,10334.97,17595943368,BTC,80.9725690265327500000,10172.990667,0.01592248909904559,-1,778143028384,10370.82,10334.97,-0.0034568144081
903,2019-09-10,10336.41,10394.35,10020.57,10115.98,10115.98,14906809639,BTC,75.6435590206047500000,10156.001333,-0.00394065850207781,-1,763236218745,10185.50,10115.98,-0.0068253890334
904,2019-09-11,10123.04,10215.95,9980.78,10178.37,10178.37,15428063426,BTC,68.0340237483610000000,10155.526000,0.00224941573681166,1,778664282171,9754.42,10178.37,0.0434623483508
905,2019-09-12,10176.82,10442.25,10099.24,10410.13,10410.13,15323563925,BTC,67.3345518889110000000,10199.240000,0.02067703083759182,1,793987846096,9510.20,10410.13,0.0946278732308
906,2019-09-13,10415.36,10441.49,10226.60,10360.55,10360.55,14109864675,BTC,67.4023027160277500000,10255.930000,0.01020092765843761,-1,779877981421,9598.17,10360.55,0.0794297246246
907,2019-09-14,10345.40,10422.13,10291.69,10358.05,10358.05,13468713124,BTC,72.1146937540580000000,10306.588667,0.00499305198477268,1,793346694545,9630.66,10358.05,0.0755285722889
908,2019-09-15,10356.47,10387.04,10313.09,10347.71,10347.71,12043433567,BTC,74.1442506567602500000,10354.392000,-0.00064533002034306,-1,781303260978,9757.97,10347.71,0.0604367506766
909,2019-09-16,10347.22,10386.87,10189.74,10276.79,10276.79,15160167779,BTC,61.8571011149062500000,10388.980000,-0.01079894272584989,-1,766143093199,10346.76,10276.79,-0.0067625034310
910,2019-09-17,10281.51,10296.77,10199.74,10241.27,10241.27,15304603363,BTC,49.4403683391555000000,10381.947333,-0.01355018750218890,-1,750838489836,10623.54,10241.27,-0.0359832974696
911,2019-09-18,10247.80,10275.93,10191.47,10198.25,10198.25,16169268880,BTC,35.4234527247495000000,10353.594667,-0.01500393554087354,-1,734669220956,10594.49,10198.25,-0.0374005733169
912,2019-09-19,10200.50,10295.67,9851.69,10266.42,10266.42,19937691247,BTC,26.5742614340457500000,10331.723333,-0.00632066218724791,1,754606912203,10575.53,10266.42,-0.0292287951526
913,2019-09-20,10266.32,10285.87,10132.19,10181.64,10181.64,14734189639,BTC,22.7442848303670000000,10305.464000,-0.01201537359210609,-1,739872722564,10353.30,10181.64,-0.0165802207992
914,2019-09-21,10183.65,10188.10,10000.71,10019.72,10019.72,13425266806,BTC,16.5730932471060000000,10283.225333,-0.02562477476345699,-1,726447455758,10517.25,10019.72,-0.0473060923721
915,2019-09-22,10024.12,10074.44,9922.53,10070.39,10070.39,13199651698,BTC,15.2797652988230000000,10253.434667,-0.01785203426410051,1,739647107456,10441.28,10070.39,-0.0355215069417
916,2019-09-23,10067.96,10074.24,9727.14,9729.32,9729.32,15144925408,BTC,7.0956721642347500000,10205.970667,-0.04670311943392145,-1,724502182048,10334.97,9729.32,-0.0586020085206
917,2019-09-24,9729.32,9804.32,8370.80,8620.57,8620.57,25002886689,BTC,3.0049103330487500000,10091.677333,-0.14577431327391411,-1,699499295359,10115.98,8620.57,-0.1478265081584
918,2019-09-25,8603.43,8744.83,8325.40,8486.99,8486.99,21744728353,BTC,3.0049103330487500000,9983.078000,-0.14986239714845461,-1,677754567006,10178.37,8486.99,-0.1661739551618
919,2019-09-26,8487.67,8515.69,7895.63,8118.97,8118.97,19258205289,BTC,0E-19,9845.784667,-0.17538619067993070,-1,658496361717,10410.13,8118.97,-0.2200894705446
920,2019-09-27,8113.10,8271.52,7965.92,8251.85,8251.85,16408941156,BTC,1.4819903817842500000,9701.899333,-0.14946035649615619,1,674905302873,10360.55,8251.85,-0.2035316657899
921,2019-09-28,8251.27,8285.62,8125.43,8245.92,8245.92,14141152736,BTC,2.8994252210932500000,9560.924000,-0.13753942610567765,-1,660764150137,10358.05,8245.92,-0.2039119332307
922,2019-09-29,8246.04,8261.71,7990.50,8104.19,8104.19,13034629109,BTC,2.8994252210932500000,9410.666667,-0.13882934262047218,-1,647729521028,10347.71,8104.19,-0.2168131886185
923,2019-09-30,8104.23,8314.23,7830.76,8293.87,8293.87,17115474183,BTC,5.0820635346347500000,9273.744000,-0.10566110084557003,1,664844995211,10276.79,8293.87,-0.1929513009412
924,2019-10-01,8299.72,8497.69,8232.68,8343.28,8343.28,15305343413,BTC,6.3644645450705000000,9144.843333,-0.08765194807739196,1,680150338624,10241.27,8343.28,-0.1853276009714
925,2019-10-02,8344.21,8393.04,8227.70,8393.04,8393.04,13125712443,BTC,8.2867530469417500000,9021.628000,-0.06967567272780478,1,693276051067,10198.25,8393.04,-0.1770117422107
926,2019-10-03,8390.77,8414.23,8146.44,8259.99,8259.99,13668823409,BTC,10.0881340286135000000,8892.410667,-0.07111914762854260,-1,679607227658,10266.42,8259.99,-0.1954361890513
927,2019-10-04,8259.49,8260.06,8151.24,8205.94,8205.94,13139456229,BTC,9.1299535840940000000,8755.045333,-0.06271873098478221,-1,666467771429,10181.64,8205.94,-0.1940453600795
928,2019-10-05,8210.15,8215.53,8071.12,8151.50,8151.50,12200497197,BTC,6.9671032355115000000,8619.702667,-0.05431772824281805,-1,654267274232,10019.72,8151.50,-0.1864543120965
929,2019-10-06,8149.88,8161.41,7958.85,7988.16,7988.16,13160830305,BTC,3.6273798943312500000,8484.265333,-0.05847357591120730,-1,641106443927,10070.39,7988.16,-0.2067675631232
930,2019-10-07,7989.12,8308.45,7905.77,8245.62,8245.62,18009742607,BTC,5.5226723947060000000,8362.614000,-0.01399012318397094,1,659116186534,9729.32,8245.62,-0.1524978107411
931,2019-10-08,8246.85,8332.71,8185.76,8228.78,8228.78,15592264032,BTC,13.8102399522270000000,8262.578000,-0.00409049088553234,-1,643523922502,8620.57,8228.78,-0.0454482708220
932,2019-10-09,8229.84,8627.71,8169.30,8595.74,8595.74,19384942333,BTC,38.2086989085895000000,8260.922667,0.04053025872491199,1,662908864835,8486.99,8595.74,0.0128137301917
933,2019-10-10,8585.28,8625.27,8471.93,8586.47,8586.47,17618660671,BTC,62.8272676567380000000,8267.554667,0.03857432407105244,1,680527525506,8118.97,8586.47,0.0575811956443
934,2019-10-11,8585.26,8721.78,8316.18,8321.76,8321.76,19604381101,BTC,72.8571816199662500000,8281.074000,0.00491313083302963,-1,660923144405,8251.85,8321.76,0.0084720396032
935,2019-10-12,8315.67,8415.24,8313.34,8336.56,8336.56,14532641605,BTC,77.6807169426250000000,8286.721333,0.00601428055768314,1,675455786010,8245.92,8336.56,0.0109921027611
936,2019-10-13,8336.90,8470.99,8276.61,8321.01,8321.01,13808286059,BTC,66.3764442542547500000,8291.727333,0.00353155209089652,-1,661647499951,8104.19,8321.01,0.0267540617878
937,2019-10-14,8320.83,8390.21,8284.13,8374.69,8374.69,15151387859,BTC,57.6623654498172500000,8309.760667,0.00781362250995381,1,676798887810,8293.87,8374.69,0.0097445462733
938,2019-10-15,8373.46,8410.71,8182.71,8205.37,8205.37,15220412632,BTC,52.8732841765692500000,8303.860667,-0.01186082846878770,-1,661578475178,8343.28,8205.37,-0.0165294704241
939,2019-10-16,8204.67,8216.81,7985.09,8047.53,8047.53,16071646996,BTC,40.9806116067020000000,8284.144000,-0.02856227511255237,-1,645506828182,8393.04,8047.53,-0.0411662520374
940,2019-10-17,8047.81,8134.83,8000.94,8103.91,8103.91,14313052244,BTC,32.0476315876097500000,8264.868667,-0.01947504231285325,1,659819880426,8259.99,8103.91,-0.0188959066536
941,2019-10-18,8100.93,8138.41,7902.16,7973.21,7973.21,15651592610,BTC,16.1431416438987500000,8245.750000,-0.03305217839493072,-1,644168287816,8205.94,7973.21,-0.0283611627675
942,2019-10-19,7973.80,8082.63,7944.78,7988.56,7988.56,13797825640,BTC,7.8220716275592500000,8231.258000,-0.02948492198883816,1,657966113456,8151.50,7988.56,-0.0199889590873
943,2019-10-20,7997.81,8281.82,7949.44,8222.08,8222.08,15504249442,BTC,15.3734809118007500000,8235.963333,-0.00168569631003237,1,673470362898,7988.16,8222.08,0.0292833393422
944,2019-10-21,8225.12,8296.69,8196.42,8243.72,8243.72,15868748866,BTC,21.4740655068830000000,8253.000667,-0.00112452032593541,1,689339111764,8245.62,8243.72,-0.0002304253652
945,2019-10-22,8243.40,8296.65,8074.46,8078.20,8078.20,16803377857,BTC,25.6903281769552500000,8241.839333,-0.01985471038543478,-1,672535733907,8228.78,8078.20,-0.0182991889442
946,2019-10-23,8076.23,8093.00,7469.32,7514.67,7514.67,21942878958,BTC,25.0738920212680000000,8194.232000,-0.08293175004076038,-1,650592854949,8595.74,7514.67,-0.1257681130420
947,2019-10-24,7509.73,7532.87,7446.99,7493.49,7493.49,16268708849,BTC,15.0795945576920000000,8120.748667,-0.07724148261711004,-1,634324146100,8586.47,7493.49,-0.1272909589156
948,2019-10-25,7490.70,8691.54,7479.98,8660.70,8660.70,28705065488,BTC,29.2162626700722500000,8125.697333,0.06584083126346001,1,663029211588,8321.76,8660.70,0.0407293649420
949,2019-10-26,8667.58,10021.74,8662.62,9244.97,9244.97,44496255609,BTC,50.0000000000000000000,8187.244667,0.12919185587103940,1,707525467197,8336.56,9244.97,0.1089670079745
950,2019-10-27,9241.71,9749.53,9112.54,9551.71,9551.71,32593129501,BTC,75.0000000000000000000,8268.254667,0.15522687491986512,1,740118596698,8321.01,9551.71,0.1479027185402
951,2019-10-28,9565.10,9805.12,9256.15,9256.15,9256.15,30948255332,BTC,96.4100047613957500000,8330.597333,0.11110279731485853,-1,709170341366,8374.69,9256.15,0.1052528511503
952,2019-10-29,9248.44,9516.18,9232.65,9427.69,9427.69,28426779937,BTC,94.9036060285100000000,8400.797333,0.12223752416525533,1,737597121303,8205.37,9427.69,0.1489658601623
953,2019-10-30,9422.46,9426.87,9085.37,9205.73,9205.73,27706531577,BTC,90.7011884055152500000,8467.488000,0.08718547932987918,-1,709890589726,8047.53,9205.73,0.1439199356821
954,2019-10-31,9202.46,9383.16,9028.72,9199.58,9199.58,26583653947,BTC,86.4240703131830000000,8544.291333,0.07669315586994627,-1,683306935779,8103.91,9199.58,0.1352026367519
955,2019-11-01,9193.99,9275.66,9132.05,9261.10,9261.10,24324691031,BTC,86.4841950811865000000,8621.437333,0.07419443444210673,1,707631626810,7973.21,9261.10,0.1615271640907
956,2019-11-02,9259.78,9377.49,9249.59,9324.72,9324.72,21242676385,BTC,85.2334784425375000000,8711.538000,0.07038734147747505,1,728874303195,7988.56,9324.72,0.1672591806283
957,2019-11-03,9324.79,9379.81,9141.25,9235.35,9235.35,21132220847,BTC,85.5932553371357500000,8794.657333,0.05010913447945249,-1,707742082348,8222.08,9235.35,0.1232376722192
958,2019-11-04,9235.61,9505.05,9191.49,9412.61,9412.61,26170255634,BTC,88.1808067164830000000,8874.026000,0.06069218188001703,1,733912337982,8243.72,9412.61,0.1417915698253
959,2019-11-05,9413.00,9457.42,9256.93,9342.53,9342.53,26198609048,BTC,89.1698895161837500000,8947.280000,0.04417543655725539,-1,707713728934,8078.20,9342.53,0.1565113515387
960,2019-11-06,9340.86,9423.24,9305.91,9360.88,9360.88,23133895765,BTC,89.6091039830532500000,9032.792000,0.03632188142935208,1,730847624699,7514.67,9360.88,0.2456807817243
961,2019-11-07,9352.39,9368.48,9202.35,9267.56,9267.56,22700383839,BTC,90.0003400996977500000,9149.651333,0.01288668417065680,-1,708147240860,7493.49,9267.56,0.2367481640731
962,2019-11-08,9265.37,9272.76,8775.53,8804.88,8804.88,24333037836,BTC,70.7353159551165000000,9237.077333,-0.04678940290517540,-1,683814203024,8660.70,8804.88,0.0166476150888
963,2019-11-09,8809.47,8891.82,8793.16,8813.58,8813.58,17578630606,BTC,48.5673345621062500000,9247.269333,-0.04689917827442606,1,701392833630,9244.97,8813.58,-0.0466621308668
964,2019-11-10,8812.49,9103.83,8806.16,9055.53,9055.53,20587919881,BTC,34.2756991599815000000,9234.640000,-0.01939545017456013,1,721980753511,9551.71,9055.53,-0.0519467194879
965,2019-11-11,9056.92,9081.28,8700.61,8757.79,8757.79,20265510765,BTC,12.7271037717335000000,9181.712000,-0.04617025670158245,-1,701715242746,9256.15,8757.79,-0.0538409597943
966,2019-11-12,8759.75,8853.77,8685.43,8815.66,8815.66,20309769107,BTC,10.8413453234332500000,9152.346000,-0.03678685224531503,1,722025011853,9427.69,8815.66,-0.0649183416086
967,2019-11-13,8812.03,8836.84,8761.65,8808.26,8808.26,17545755405,BTC,12.4769797854682500000,9111.050667,-0.03323334246144633,-1,704479256448,9205.73,8808.26,-0.0431763695003
968,2019-11-14,8811.94,8826.94,8692.55,8708.09,8708.09,19084739975,BTC,4.0865160922582500000,9077.874667,-0.04073471826442435,-1,685394516473,9199.58,8708.09,-0.0534252650664
969,2019-11-15,8705.71,8730.87,8484.84,8491.99,8491.99,21796856471,BTC,4.0865160922582500000,9030.702000,-0.05965339128674604,-1,663597660002,9261.10,8491.99,-0.0830473701828
970,2019-11-16,8491.17,8592.00,8473.97,8550.76,8550.76,16495389808,BTC,3.5228007460425000000,8983.346000,-0.04815421781594519,1,680093049810,9324.72,8550.76,-0.0830008836726
971,2019-11-17,8549.47,8727.79,8500.97,8577.98,8577.98,18668638897,BTC,3.9310464686842500000,8933.563333,-0.03980307966100138,1,698761688707,9235.35,8577.98,-0.0711797603772
972,2019-11-18,8573.98,8653.28,8273.57,8309.29,8309.29,21579470673,BTC,3.9310464686842500000,8871.826000,-0.06340701451989703,-1,677182218034,9412.61,8309.29,-0.1172172224282
973,2019-11-19,8305.13,8408.52,8099.96,8206.15,8206.15,21083613816,BTC,3.9310464686842500000,8791.395333,-0.06657024406617024,-1,656098604218,9342.53,8206.15,-0.1216351459401
974,2019-11-20,8203.61,8237.24,8010.51,8027.27,8027.27,20764300437,BTC,2.3351111207665000000,8703.711333,-0.07771872332613814,-1,635334303781,9360.88,8027.27,-0.1424663065866
975,2019-11-21,8023.64,8110.10,7597.38,7642.75,7642.75,22514243371,BTC,0E-19,8589.169333,-0.11018752760686782,-1,612820060410,9267.56,7642.75,-0.1753223070582
976,2019-11-22,7643.57,7697.38,6936.71,7296.58,7296.58,34242315785,BTC,0E-19,8457.770667,-0.13729275866164840,-1,578577744625,8804.88,7296.58,-0.1713027321213
977,2019-11-23,7296.16,7442.26,7151.42,7397.80,7397.80,21008924418,BTC,1.4386423718695000000,8363.965333,-0.11551522448186120,1,599586669043,8813.58,7397.80,-0.1606362000458
978,2019-11-24,7398.63,7408.58,7029.29,7047.92,7047.92,30433517289,BTC,1.4386423718695000000,8246.254667,-0.14531865863851085,-1,569153151754,9055.53,7047.92,-0.2216998894598
979,2019-11-25,7039.98,7319.86,6617.17,7146.13,7146.13,42685231262,BTC,2.8275626882055000000,8118.961333,-0.11982214141676834,1,611838383016,8757.79,7146.13,-0.1840258786749
980,2019-11-26,7145.16,7320.23,7098.57,7218.37,7218.37,21129505542,BTC,5.2381264588957500000,8016.333333,-0.09954218466878216,1,632967888558,8815.66,7218.37,-0.1811877953551
981,2019-11-27,7220.88,7619.69,6974.17,7531.66,7531.66,23991412764,BTC,10.6694637500460000000,7930.733333,-0.05031985268492699,1,656959301322,8808.26,7531.66,-0.1449321432383
982,2019-11-28,7536.82,7730.07,7454.12,7463.11,7463.11,19050116751,BTC,16.9216849081202500000,7841.056667,-0.04820098655716041,-1,637909184571,8708.09,7463.11,-0.1429682054274
983,2019-11-29,7466.73,7781.18,7460.76,7761.24,7761.24,19709695456,BTC,27.1878630846537500000,7777.933333,-0.00214624274666562,1,657618880027,8491.99,7761.24,-0.0860516792884
984,2019-11-30,7764.06,7836.10,7515.85,7569.63,7569.63,17158194786,BTC,33.3016382287772500000,7716.442667,-0.01902595189722026,-1,640460685241,8550.76,7569.63,-0.1147418475083
985,2019-12-01,7571.62,7571.62,7291.34,7424.29,7424.29,18720708479,BTC,32.5812540064592500000,7641.344667,-0.02840529729503955,-1,621739976762,8577.98,7424.29,-0.1344943681380
986,2019-12-02,7424.04,7474.82,7233.40,7321.99,7321.99,17082040706,BTC,31.7610234617657500000,7557.612000,-0.03117677912017711,-1,604657936056,8309.29,7321.99,-0.1188188160481
987,2019-12-03,7323.98,7418.86,7229.36,7320.15,7320.15,14797485769,BTC,25.9819167839935000000,7491.669333,-0.02289467478823121,-1,589860450287,8206.15,7320.15,-0.1079678046343
988,2019-12-04,7320.13,7539.78,7170.92,7252.03,7252.03,21664240918,BTC,22.6679214644215000000,7428.061333,-0.02369815287038099,-1,568196209369,8027.27,7252.03,-0.0965757972511
989,2019-12-05,7253.24,7743.43,7232.68,7448.31,7448.31,18816085231,BTC,30.5509481288057500000,7389.464000,0.00796350046498636,1,587012294600,7642.75,7448.31,-0.0254411043145
990,2019-12-06,7450.56,7547.00,7392.18,7547.00,7547.00,18104466307,BTC,42.6104059537135000000,7383.080667,0.02220202384252238,1,605116760907,7296.58,7547.00,0.0343201883622
991,2019-12-07,7547.27,7589.95,7525.71,7556.24,7556.24,15453520564,BTC,54.5497004056492500000,7400.391333,0.02105951698865382,1,620570281471,7397.80,7556.24,0.0214171780800
992,2019-12-08,7551.34,7634.61,7476.09,7564.35,7564.35,15409908086,BTC,67.4388773621935000000,7411.494667,0.02062408999369519,1,635980189557,7047.92,7564.35,0.0732741007276
993,2019-12-09,7561.80,7618.09,7365.99,7400.90,7400.90,17872021272,BTC,63.7609072705685000000,7435.026667,-0.00458998582365138,-1,618108168285,7146.13,7400.90,0.0356514644990
994,2019-12-10,7397.13,7424.02,7246.04,7278.12,7278.12,18249031195,BTC,49.0210384001322500000,7443.826000,-0.02226086423836344,-1,599859137090,7218.37,7278.12,0.0082774920100
995,2019-12-11,7277.20,7324.16,7195.53,7217.43,7217.43,16350490689,BTC,31.2057521330992500000,7443.763333,-0.03040576693197777,-1,583508646401,7531.66,7217.43,-0.0417212141812
996,2019-12-12,7216.74,7266.64,7164.74,7243.13,7243.13,18927080224,BTC,14.2877104066382500000,7424.528000,-0.02443226020563193,1,602435726625,7463.11,7243.13,-0.0294756475518
997,2019-12-13,7244.66,7293.56,7227.12,7269.68,7269.68,17125736940,BTC,6.3350921917465000000,7411.632667,-0.01915268516099545,1,619561463565,7761.24,7269.68,-0.0633352402451
998,2019-12-14,7268.90,7308.84,7097.21,7124.67,7124.67,17137029730,BTC,3.5835126238942500000,7369.194667,-0.03318200672524044,-1,602424433835,7569.63,7124.67,-0.0587822654476
999,2019-12-15,7124.24,7181.08,6924.38,7152.30,7152.30,16881129804,BTC,5.1545415540252500000,7341.372667,-0.02575440255878785,1,619305563639,7424.29,7152.30,-0.0366351529911
1000,2019-12-16,7153.66,7171.17,6903.68,6932.48,6932.48,20213265950,BTC,3.9730627287002500000,7308.585333,-0.05146075688571289,-1,599092297689,7321.99,6932.48,-0.0531972865300
1001,2019-12-17,6931.32,6964.08,6587.97,6640.52,6640.52,22363804217,BTC,1.5710289301310000000,7263.154000,-0.08572501698298012,-1,576728493472,7320.15,6640.52,-0.0928437258799
1002,2019-12-18,6647.70,7324.98,6540.05,7276.80,7276.80,31836522778,BTC,18.7895648079440000000,7260.264000,0.00227760312848128,1,608565016250,7252.03,7276.80,0.0034155953574
1003,2019-12-19,7277.59,7346.60,7041.38,7202.84,7202.84,25904604416,BTC,32.4356212723120000000,7256.984667,-0.00746104194572911,-1,582660411834,7448.31,7202.84,-0.0329564693199
1004,2019-12-20,7208.64,7257.92,7086.12,7218.82,7218.82,22633815180,BTC,48.0851455354340000000,7241.685333,-0.00315746016963811,1,605294227014,7547.00,7218.82,-0.0434848284086
1005,2019-12-21,7220.59,7223.23,7112.74,7191.16,7191.16,19312552168,BTC,62.9861554615027500000,7217.962667,-0.00371332857158431,-1,585981674846,7556.24,7191.16,-0.0483150349909
1006,2019-12-22,7191.19,7518.03,7167.18,7511.59,7511.59,23134537956,BTC,69.3398677245815000000,7214.986000,0.04110943527818349,1,609116212802,7564.35,7511.59,-0.0069748226880
1007,2019-12-23,7508.90,7656.18,7326.19,7355.63,7355.63,27831788041,BTC,74.6466782282307500000,7201.071333,0.02146328787102990,-1,581284424761,7400.90,7355.63,-0.0061168236296
1008,2019-12-24,7354.39,7535.72,7269.53,7322.53,7322.53,22991622105,BTC,78.5710688054775000000,7195.846667,0.01760506287341656,-1,558292802656,7278.12,7322.53,0.0061018504779
1009,2019-12-25,7325.76,7357.02,7220.99,7275.16,7275.16,21559505149,BTC,81.8844388947922500000,7195.649333,0.01104982515411858,-1,536733297507,7217.43,7275.16,0.0079986920552
1010,2019-12-26,7274.80,7388.30,7200.39,7238.97,7238.97,22787010034,BTC,75.4879056792222500000,7197.085333,0.00581967075031761,-1,513946287473,7243.13,7238.97,-0.0005743373376
1011,2019-12-27,7238.14,7363.53,7189.93,7290.09,7290.09,22777360996,BTC,73.6068857841507500000,7200.216000,0.01248212553623391,1,536723648469,7269.68,7290.09,0.0028075513640
1012,2019-12-28,7289.03,7399.04,7286.91,7317.99,7317.99,21365673026,BTC,73.4765862674642500000,7203.436667,0.01590259459415887,1,558089321495,7124.67,7317.99,0.0271338883064
1013,2019-12-29,7317.65,7513.95,7279.87,7422.65,7422.65,22445257702,BTC,77.7095985397270000000,7223.302000,0.02759790467019100,1,580534579197,7152.30,7422.65,0.0377990296828
1014,2019-12-30,7420.27,7454.82,7276.31,7293.00,7293.00,22874131672,BTC,79.2602775896310000000,7232.682000,0.00833964496157857,-1,557660447525,6932.48,7293.00,0.0520044774742
1015,2019-12-31,7294.44,7335.29,7169.78,7193.60,7193.60,21167946112,BTC,76.4909823550345000000,7250.090000,-0.00779162741428037,-1,536492501413,6640.52,7193.60,0.0832886581171
1016,2020-01-01,7194.89,7254.33,7174.94,7200.17,7200.17,18565664997,BTC,57.7503286766415000000,7287.400000,-0.01196997557427889,1,555058166410,7276.80,7200.17,-0.0105307277924
1017,2020-01-02,7202.55,7212.16,6935.27,6985.47,6985.47,20802083465,BTC,35.3029363889952500000,7267.978000,-0.03887023323405767,-1,534256082945,7202.84,6985.47,-0.0301783740858
1018,2020-01-03,6984.43,7413.72,6915.00,7344.88,7344.88,28111481032,BTC,33.6548705518367500000,7277.447333,0.00926597801597584,1,562367563977,7218.82,7344.88,0.0174626878077
1019,2020-01-04,7345.38,7427.39,7309.51,7410.66,7410.66,18444271275,BTC,37.9853306865725000000,7290.236667,0.01651843945548551,1,580811835252,7191.16,7410.66,0.0305235872933
1020,2020-01-05,7410.45,7544.50,7400.54,7411.32,7411.32,19725074095,BTC,57.5177716110392500000,7304.914000,0.01456635902900431,1,600536909347,7511.59,7411.32,-0.0133487051343
1021,2020-01-06,7410.45,7781.87,7409.29,7769.22,7769.22,23276261598,BTC,82.5177716110392500000,7322.089333,0.06106599450853764,1,623813170945,7355.63,7769.22,0.0562276786625
1022,2020-01-07,7768.68,8178.22,7768.23,8163.69,8163.69,28767291327,BTC,90.4394434729720000000,7375.960000,0.10679694575350192,1,652580462272,7322.53,8163.69,0.1148728649797
1023,2020-01-08,8161.94,8396.74,7956.77,8079.86,8079.86,31672559265,BTC,93.4566600598682500000,7426.448667,0.08798435999476895,-1,620907903007,7275.16,8079.86,0.1106092512055
1024,2020-01-09,8082.30,8082.30,7842.40,7879.07,7879.07,24045990466,BTC,92.1820627726570000000,7466.709333,0.05522655946676852,-1,596861912541,7238.97,7879.07,0.0884241818933
1025,2020-01-10,7878.31,8166.55,7726.77,8166.55,8166.55,28714583844,BTC,92.1820627726570000000,7528.548000,0.08474436239232319,1,625576496385,7290.09,8166.55,0.1202262249163
1026,2020-01-11,8162.19,8218.36,8029.64,8037.54,8037.54,25521165085,BTC,89.4512994035372500000,7578.378000,0.06058842670555625,-1,600055331300,7317.99,8037.54,0.0983261797297
1027,2020-01-12,8033.26,8200.06,8009.06,8192.49,8192.49,22903438381,BTC,91.2300419134250000000,7636.678000,0.07278190857333516,1,622958769681,7422.65,8192.49,0.1037149804989
1028,2020-01-13,8189.77,8197.79,8079.70,8144.19,8144.19,22482910688,BTC,96.2688389572707500000,7684.780667,0.05978171048821165,-1,600475858993,7293.00,8144.19,0.1167132867133
1029,2020-01-14,8140.93,8879.51,8140.93,8827.76,8827.76,44841784107,BTC,96.2688389572707500000,7787.098000,0.13363925816780526,1,645317643100,7193.60,8827.76,0.2271685943060
1030,2020-01-15,8825.34,8890.12,8657.19,8807.01,8807.01,40102834650,BTC,98.7180234218750000000,7894.658667,0.11556564653183377,-1,605214808450,7200.17,8807.01,0.2231669530025
1031,2020-01-16,8812.48,8846.46,8612.10,8723.79,8723.79,31313981931,BTC,97.3071434844057500000,7996.233333,0.09098742329059046,-1,573900826519,6985.47,8723.79,0.2488479658491
1032,2020-01-17,8725.21,8958.12,8677.32,8929.04,8929.04,36372139320,BTC,98.3075411580152500000,8125.804667,0.09884994359537685,1,610272965839,7344.88,8929.04,0.2156822167278
1033,2020-01-18,8927.21,9012.20,8827.33,8942.81,8942.81,32337772627,BTC,98.3075411580152500000,8232.333333,0.08630319476399171,1,642610738466,7410.66,8942.81,0.2067494663093
1034,2020-01-19,8941.45,9164.36,8620.08,8706.25,8706.25,34217320471,BTC,94.7275212274095000000,8318.706000,0.04658705332295672,-1,608393417995,7411.32,8706.25,0.1747232611734
1035,2020-01-20,8704.63,8745.59,8560.47,8657.64,8657.64,26422375678,BTC,90.0636646725772500000,8401.794000,0.03045135360376605,-1,581971042317,7769.22,8657.64,0.1143512476156
1036,2020-01-21,8658.99,8755.71,8544.52,8745.89,8745.89,24097418512,BTC,85.4356540684822500000,8466.905333,0.03295001609533172,1,606068460829,8163.69,8745.89,0.0713157897960
1037,2020-01-22,8744.21,8792.99,8636.75,8680.88,8680.88,22600204051,BTC,79.2797795126697500000,8501.384667,0.02111365854279606,-1,583468256778,8079.86,8680.88,0.0743849522145
1038,2020-01-23,8680.65,8687.75,8333.64,8406.52,8406.52,25770680779,BTC,70.5374995804230000000,8523.162000,-0.01368529660705733,-1,557697575999,7879.07,8406.52,0.0669431798423
1039,2020-01-24,8405.57,8514.67,8266.84,8445.43,8445.43,24397913026,BTC,62.8765550051977500000,8560.919333,-0.01349029566892661,1,582095489025,8166.55,8445.43,0.0341490592723
1040,2020-01-25,8440.12,8458.45,8296.22,8367.85,8367.85,19647331549,BTC,51.6264298045052500000,8574.339333,-0.02408224412174661,-1,562448157476,8037.54,8367.85,0.0410959074543
1041,2020-01-26,8364.41,8602.40,8325.50,8596.83,8596.83,22177678796,BTC,46.9517466482645000000,8611.625333,-0.00171806510709469,1,584625836272,8192.49,8596.83,0.0493549580164
1042,2020-01-27,8597.31,8977.73,8597.31,8909.82,8909.82,28647338393,BTC,58.5229064754607500000,8659.447333,0.02891323861349247,1,613273174665,8144.19,8909.82,0.0940093489960
1043,2020-01-28,8912.52,9358.59,8908.45,9358.59,9358.59,34398744403,BTC,72.2585875429875000000,8740.407333,0.07072698599137473,1,647671919068,8827.76,9358.59,0.0601319020907
1044,2020-01-29,9357.47,9406.43,9269.47,9316.63,9316.63,30682598115,BTC,87.0779188178277500000,8772.998667,0.06196642147512138,-1,616989320953,8807.01,9316.63,0.0578652686894
1045,2020-01-30,9316.02,9553.13,9230.90,9508.99,9508.99,32378792851,BTC,97.9084765298810000000,8819.797333,0.07814155370910040,1,649368113804,8723.79,9508.99,0.0900067516527
1046,2020-01-31,9508.31,9521.71,9230.78,9350.53,9350.53,29432489719,BTC,95.4696669985242500000,8861.580000,0.05517639066622431,-1,619935624085,8929.04,9350.53,0.0472044027129
1047,2020-02-01,9346.36,9439.32,9313.24,9392.88,9392.88,25922656496,BTC,92.9259387969012500000,8892.502667,0.05626957356525694,1,645858280581,8942.81,9392.88,0.0503275815991
1048,2020-02-02,9389.82,9468.80,9217.82,9344.37,9344.37,30835736946,BTC,90.3782620887882500000,8919.273333,0.04766045967301000,-1,615022543635,8706.25,9344.37,0.0732944723618
1049,2020-02-03,9344.68,9540.37,9248.63,9293.52,9293.52,30934096509,BTC,85.6577632893420000000,8958.424667,0.03740560929583804,-1,584088447126,8657.64,9293.52,0.0734472673846
1050,2020-02-04,9292.84,9331.27,9112.81,9180.96,9180.96,29893183716,BTC,81.9428378638902500000,8993.312667,0.02086520728769409,-1,554195263410,8745.89,9180.96,0.0497456519577
1051,2020-02-05,9183.42,9701.30,9163.70,9613.42,9613.42,35222060874,BTC,84.4865660655132500000,9051.148000,0.06212162258312426,1,589417324284,8680.88,9613.42,0.1074245928984
1052,2020-02-06,9617.82,9824.62,9539.82,9729.80,9729.80,37628823716,BTC,88.0930473035735000000,9121.076000,0.06673817869733790,1,627046148000,8406.52,9729.80,0.1574111522961
1053,2020-02-07,9726.00,9834.72,9726.00,9795.94,9795.94,34522718159,BTC,92.8135461030197500000,9213.704000,0.06319239254918543,1,661568866159,8445.43,9795.94,0.1599101525914
1054,2020-02-08,9793.07,9876.75,9678.91,9865.12,9865.12,35172043762,BTC,100.0000000000000000000,9308.350000,0.05981403793368320,1,696740909921,8367.85,9865.12,0.1789312666934
1055,2020-02-09,9863.89,10129.44,9850.39,10116.67,10116.67,35807884663,BTC,100.0000000000000000000,9424.938000,0.07339379845257338,1,732548794584,8596.83,10116.67,0.1767907472871
1056,2020-02-10,10115.56,10165.77,9784.56,9856.61,9856.61,39386548075,BTC,94.6128350664955000000,9508.923333,0.03656425179004017,-1,693162246509,8909.82,9856.61,0.1062636506686
1057,2020-02-11,9855.89,10210.05,9729.33,10208.24,10208.24,37648059389,BTC,94.6128350664955000000,9595.484667,0.06385871628843696,1,730810305898,9358.59,10208.24,0.0907882490845
1058,2020-02-12,10202.39,10393.61,10202.39,10326.05,10326.05,43444303830,BTC,94.6128350664955000000,9659.982000,0.06895126719697821,1,774254609728,9316.63,10326.05,0.1083460435801
1059,2020-02-13,10323.96,10457.63,10116.16,10214.38,10214.38,49356071373,BTC,92.1748170941090000000,9719.832000,0.05088030328096206,-1,724898538355,9508.99,10214.38,0.0741813799362
1060,2020-02-14,10211.55,10322.00,10125.53,10312.12,10312.12,43338264162,BTC,97.2578574609855000000,9773.374000,0.05512384975751465,1,768236802517,9350.53,10312.12,0.1028380209464
1061,2020-02-15,10313.86,10341.56,9874.43,9889.42,9889.42,43865054831,BTC,87.7252006392510000000,9809.300000,0.00816775916732081,-1,724371747686,9392.88,9889.42,0.0528634455034
1062,2020-02-16,9889.18,10053.97,9722.39,9934.43,9934.43,43374780305,BTC,79.1752176684802500000,9845.403333,0.00904246011959701,1,767746527991,9344.37,9934.43,0.0631460440886
1063,2020-02-17,9936.56,9938.82,9507.64,9690.14,9690.14,45998298413,BTC,67.7298290964030000000,9868.454667,-0.01806915804115534,-1,721748229578,9293.52,9690.14,0.0426770480937
1064,2020-02-18,9691.23,10161.94,9632.38,10142.00,10142.00,47271023953,BTC,64.0157105555022500000,9925.020000,0.02186192068126815,1,769019253531,9180.96,10142.00,0.1046775064917
1065,2020-02-19,10143.80,10191.68,9611.22,9633.39,9633.39,46992019710,BTC,49.2489413076072500000,9955.182000,-0.03232407001700220,-1,722027233821,9613.42,9633.39,0.0020773044348
1066,2020-02-20,9629.33,9643.22,9507.90,9608.48,9608.48,44925260237,BTC,32.7989242783780000000,9954.852667,-0.03479435392833223,-1,677101973584,9729.80,9608.48,-0.0124689099468
1067,2020-02-21,9611.78,9723.01,9589.74,9686.44,9686.44,40930547513,BTC,24.3984421429917500000,9951.962000,-0.02668036714770414,1,718032521097,9795.94,9686.44,-0.0111781003150
1068,2020-02-22,9687.71,9698.23,9600.73,9663.18,9663.18,35838025154,BTC,5.3224226698662500000,9943.111333,-0.02815329363465350,-1,682194495943,9865.12,9663.18,-0.0204701007185
1069,2020-02-23,9663.32,9937.40,9657.79,9924.52,9924.52,41185185761,BTC,15.6326212076870000000,9947.071333,-0.00226713293240239,1,723379681704,10116.67,9924.52,-0.0189934039560
1070,2020-02-24,9921.58,9951.75,9537.04,9650.17,9650.17,45080496648,BTC,17.0850927435650000000,9915.971333,-0.02680537529545115,-1,678299185056,9856.61,9650.17,-0.0209443206133
1071,2020-02-25,9651.31,9652.74,9305.02,9341.71,9341.71,42515259129,BTC,14.3689814234150000000,9881.644667,-0.05464016215874725,-1,635783925927,10208.24,9341.71,-0.0848853475232
1072,2020-02-26,9338.29,9354.78,8704.43,8820.52,8820.52,50420050762,BTC,12.4632440040692500000,9789.130000,-0.09894750606029341,-1,585363875165,10326.05,8820.52,-0.1457992165446
1073,2020-02-27,8825.09,8932.89,8577.20,8784.49,8784.49,45470195695,BTC,1.4524715358780000000,9686.359333,-0.09310715223287907,-1,539893679470,10214.38,8784.49,-0.1399879385729
1074,2020-02-28,8788.73,8890.46,8492.93,8672.46,8672.46,44605450443,BTC,0E-19,9583.564667,-0.09506949644084871,-1,495288229027,10312.12,8672.46,-0.1590031923601
1075,2020-02-29,8671.21,8775.63,8599.51,8599.51,8599.51,35792392544,BTC,0E-19,9469.390667,-0.09186236977543425,-1,459495836483,9889.42,8599.51,-0.1304333317829
1076,2020-03-01,8599.76,8726.80,8471.21,8562.45,8562.45,35349164300,BTC,0E-19,9380.926000,-0.08724895601990678,-1,424146672183,9934.43,8562.45,-0.1381035449442
1077,2020-03-02,8563.26,8921.31,8532.63,8869.67,8869.67,42857674409,BTC,4.8624608274507500000,9309.942000,-0.04729052017724708,1,467004346592,9690.14,8869.67,-0.0846706033143
1078,2020-03-03,8865.39,8901.60,8704.99,8787.79,8787.79,42386715821,BTC,8.4289829381785000000,9249.785333,-0.04994660052831304,-1,424617630771,10142.00,8787.79,-0.1335249457701
1079,2020-03-04,8788.54,8843.37,8712.43,8755.25,8755.25,34746706368,BTC,11.9677144277495000000,9157.335333,-0.04390855181976549,-1,389870924403,9633.39,8755.25,-0.0911558651731
1080,2020-03-05,8760.29,9142.05,8757.25,9078.76,9078.76,39698054597,BTC,21.4442831797225000000,9120.360000,-0.00456122346047744,1,429568979000,9608.48,9078.76,-0.0551304680865
1081,2020-03-06,9078.31,9167.70,9032.08,9122.55,9122.55,40826885651,BTC,26.8621310001385000000,9087.964667,0.00380561921918396,1,470395864651,9686.44,9122.55,-0.0582143697788
1082,2020-03-07,9121.60,9163.22,8890.74,8909.95,8909.95,36216930370,BTC,29.6737686022007500000,9036.198667,-0.01397143551757636,-1,434178934281,9663.18,8909.95,-0.0779484600308
1083,2020-03-08,8908.21,8914.34,8105.25,8108.12,8108.12,39973102121,BTC,26.1350371126297500000,8932.528000,-0.09229279773878123,-1,394205832160,9924.52,8108.12,-0.1830214458735
1084,2020-03-09,8111.15,8177.79,7690.10,7923.64,7923.64,46936995808,BTC,16.6584683606567500000,8799.136000,-0.09949795070788768,-1,347268836352,9650.17,7923.64,-0.1789118740913
1085,2020-03-10,7922.15,8136.95,7814.76,7909.73,7909.73,42213940994,BTC,6.3781597127900000000,8683.106667,-0.08906681636645153,-1,305054895358,9341.71,7909.73,-0.1532888518269
1086,2020-03-11,7910.09,7950.81,7642.81,7911.43,7911.43,38682762605,BTC,0.0350422981152500000,8587.754667,-0.07875453983319992,1,343737657963,8820.52,7911.43,-0.1030653521561
1087,2020-03-12,7913.62,7929.12,4860.35,4970.79,4970.79,53980357243,BTC,0.0350422981152500000,8331.106000,-0.40334572624571095,-1,289757300720,8784.49,4970.79,-0.4341401720532
1088,2020-03-13,5017.83,5838.11,4106.98,5563.71,5563.71,74156772075,BTC,3.6053353786402500000,8116.387333,-0.31450905781950562,1,363914072795,8672.46,5563.71,-0.3584623048132
1089,2020-03-14,5573.08,5625.23,5125.07,5200.37,5200.37,36154506008,BTC,4.9877611450622500000,7884.914667,-0.34046591248924673,-1,327759566787,8599.51,5200.37,-0.3952713584844
1090,2020-03-15,5201.07,5836.65,5169.28,5392.31,5392.31,33997889639,BTC,7.4909195136522500000,7671.101333,-0.29706182125335249,1,361757456426,8562.45,5392.31,-0.3702374904379
1091,2020-03-16,5385.23,5385.23,4575.36,5014.48,5014.48,45368026430,BTC,7.7540007129507500000,7434.570000,-0.32551848997319280,-1,316389429996,8869.67,5014.48,-0.4346486396901
1092,2020-03-17,5002.58,5371.35,4981.91,5225.63,5225.63,38622642935,BTC,5.7182375667187500000,7191.634000,-0.27337375622841763,1,355012072931,8787.79,5225.63,-0.4053533368458
1093,2020-03-18,5227.11,5331.83,5069.34,5238.44,5238.44,37878801016,BTC,5.9474776962060000000,6955.010667,-0.24681064475497518,1,392890873947,8755.25,5238.44,-0.4016801347763
1094,2020-03-19,5245.42,6329.74,5236.97,6191.19,6191.19,51000731797,BTC,10.7579677052622500000,6784.073333,-0.08739341453106312,1,443891605744,9078.76,6191.19,-0.3180577523803
1095,2020-03-20,6191.65,6844.26,5865.78,6198.78,6198.78,54442976103,BTC,17.8892806905987500000,6592.074667,-0.05966174336113599,1,498334581847,9122.55,6198.78,-0.3204992025256
1096,2020-03-21,6206.52,6378.14,5932.82,6185.07,6185.07,42494390880,BTC,24.0612160940935000000,6396.242667,-0.03301511183893924,-1,455840190967,8909.95,6185.07,-0.3058243873422
1097,2020-03-22,6185.56,6359.70,5823.71,5830.25,5830.25,40099664740,BTC,29.2982081334350000000,6190.929333,-0.05825931998245279,-1,415740526227,8108.12,5830.25,-0.2809368879592
1098,2020-03-23,5831.37,6443.93,5785.00,6416.31,6416.31,46491916000,BTC,34.1878634623807500000,6078.142000,0.05563673899030329,1,462232442227,7923.64,6416.31,-0.1902320145792
1099,2020-03-24,6436.64,6789.02,6411.07,6734.80,6734.80,48221910672,BTC,41.7902896977902500000,5998.886000,0.12267511001209225,1,510454352899,7909.73,6734.80,-0.1485423649101
1100,2020-03-25,6738.72,6892.51,6536.93,6681.06,6681.06,44590107888,BTC,48.6237714463510000000,5916.974667,0.12913446076783752,-1,465864245011,7911.43,6681.06,-0.1555180289783
1101,2020-03-26,6675.17,6735.46,6590.96,6716.44,6716.44,35319797642,BTC,66.5149109045390000000,5837.308667,0.15060559294559573,1,501184042653,4970.79,6716.44,0.3511816029243
1102,2020-03-27,6719.39,6793.84,6466.70,6469.80,6469.80,34585598367,BTC,75.4255371840580000000,5937.242667,0.08969775413762787,-1,466598444286,5563.71,6469.80,0.1628571582631
1103,2020-03-28,6467.25,6467.50,6117.84,6242.19,6242.19,34885225901,BTC,78.2700195448915000000,5982.474667,0.04341269248202903,-1,431713218385,5200.37,6242.19,0.2003357453412
1104,2020-03-29,6245.62,6250.47,5920.09,5922.04,5922.04,28373690931,BTC,76.9188977933645000000,6030.586000,-0.01799924584443369,-1,403339527454,5392.31,5922.04,0.0982380464031
1105,2020-03-30,5925.54,6517.20,5903.23,6429.84,6429.84,37101651525,BTC,72.7473667689732500000,6099.754667,0.05411452607852892,1,440441178979,5014.48,6429.84,0.2822545907053
1106,2020-03-31,6430.61,6504.52,6374.16,6438.64,6438.64,32786468812,BTC,71.6923865466087500000,6194.698667,0.03937904749096329,1,473227647791,5225.63,6438.64,0.2321270354005
1107,2020-04-01,6437.32,6612.57,6202.37,6606.78,6606.78,40346426266,BTC,76.7122268061755000000,6286.775333,0.05090124110531818,1,513574074057,5238.44,6606.78,0.2612113529982
1108,2020-04-02,6606.78,7088.25,6595.92,6793.62,6793.62,47660646124,BTC,88.5234014713540000000,6390.454000,0.06308878837090448,1,561234720181,6191.19,6793.62,0.0973043954393
1109,2020-04-03,6797.40,7003.22,6673.34,6733.39,6733.39,38976504903,BTC,91.3921323100252500000,6426.600667,0.04773741965567191,-1,522258215278,6198.78,6733.39,0.0862443900251
1110,2020-04-04,6738.38,6878.95,6696.48,6867.53,6867.53,33185988584,BTC,96.2981402481635000000,6471.184000,0.06124783347220540,1,555444203862,6185.07,6867.53,0.1103398991442
1111,2020-04-05,6862.54,6883.41,6715.93,6791.13,6791.13,29510409856,BTC,96.5956428964430000000,6511.588000,0.04292992738484069,-1,525933794006,5830.25,6791.13,0.1648093992539
1112,2020-04-06,6788.05,7271.78,6782.89,7271.78,7271.78,46896904615,BTC,96.5956428964430000000,6607.690000,0.10050259621743756,1,572830698621,6416.31,7271.78,0.1333274109262
1113,2020-04-07,7273.64,7427.94,7136.71,7176.41,7176.41,44243482668,BTC,96.3921943721745000000,6658.363333,0.07780390481734019,-1,528587215953,6734.80,7176.41,0.0655713606937
1114,2020-04-08,7179.28,7356.22,7153.31,7334.10,7334.10,37563249549,BTC,96.3921943721745000000,6698.316667,0.09491688204773255,1,566150465502,6681.06,7334.10,0.0977449686128
1115,2020-04-09,7337.97,7341.45,7179.09,7302.09,7302.09,34815139178,BTC,97.6668234734732500000,6739.718667,0.08344136614389634,-1,531335326324,6716.44,7302.09,0.0871964909982
1116,2020-04-10,7303.82,7303.82,6802.48,6865.49,6865.49,43622840992,BTC,89.3702567553452500000,6749.655333,0.01716156770756401,-1,487712485332,6469.80,6865.49,0.0611595412532
1117,2020-04-11,6867.44,6926.07,6789.92,6859.08,6859.08,31222085946,BTC,82.7266546747305000000,6775.607333,0.01231958448853045,-1,456490399386,6242.19,6859.08,0.0988258928357
1118,2020-04-12,6858.07,7119.95,6811.08,6971.09,6971.09,35759567632,BTC,76.2996968967325000000,6824.200667,0.02152476753948889,1,492249967018,5922.04,6971.09,0.1771433492513
1119,2020-04-13,6965.62,6965.62,6668.26,6845.04,6845.04,38619308647,BTC,63.3454215095360000000,6885.734000,-0.00590990009198729,-1,453630658371,6429.84,6845.04,0.0645739240790
1120,2020-04-14,6843.28,6958.56,6793.82,6842.43,6842.43,34110434052,BTC,57.9152444311795000000,6913.240000,-0.01024266479971764,-1,419520224319,6438.64,6842.43,0.0627135544152
1121,2020-04-15,6845.56,6928.66,6633.40,6642.11,6642.11,32288311031,BTC,42.5396876430060000000,6926.804667,-0.04110043240519171,-1,387231913288,6606.78,6642.11,0.0053475369242
1122,2020-04-16,6640.45,7134.45,6555.50,7116.80,7116.80,46783242377,BTC,41.1160984477817500000,6960.806000,0.02241033581455941,1,434015155665,6793.62,7116.80,0.0475711034765
1123,2020-04-17,7116.55,7167.18,7050.33,7096.18,7096.18,32513423567,BTC,46.0415991099850000000,6980.976667,0.01650246641627974,-1,401501732098,6733.39,7096.18,0.0538792495311
1124,2020-04-18,7092.29,7269.96,7089.25,7257.67,7257.67,32447188386,BTC,57.0071035822017500000,7015.928667,0.03445607053233741,1,433948920484,6867.53,7257.67,0.0568093623180
1125,2020-04-19,7260.92,7280.52,7167.05,7189.42,7189.42,31311210215,BTC,75.5657596208035000000,7037.388000,0.02160346992378422,-1,402637710269,6791.13,7189.42,0.0586485606961
1126,2020-04-20,7186.87,7240.29,6835.50,6881.96,6881.96,37747113936,BTC,67.0815329701295000000,7043.443333,-0.02292675973460551,-1,364890596333,7271.78,6881.96,-0.0536072323420
1127,2020-04-21,6879.78,6934.55,6834.44,6880.32,6880.32,32589741511,BTC,59.2830098700847500000,7017.346000,-0.01952675555687293,1,397480337844,7176.41,6880.32,-0.0412587909554
1128,2020-04-22,6879.44,7145.87,6867.78,7117.21,7117.21,33249153866,BTC,54.2085145739100000000,7013.399333,0.01480176189476932,1,430729491710,7334.10,7117.21,-0.0295728173873
1129,2020-04-23,7121.31,7491.79,7081.59,7429.72,7429.72,43500782316,BTC,59.4354687206462500000,7019.774000,0.05839874617046076,1,474230274026,7302.09,7429.72,0.0174785575089
1130,2020-04-24,7434.18,7574.20,7434.18,7550.90,7550.90,34636526286,BTC,75.7702423445425000000,7036.361333,0.07312567428663061,1,508866800312,6865.49,7550.90,0.0998340977847
1131,2020-04-25,7550.48,7641.36,7521.67,7569.94,7569.94,32941541447,BTC,92.1642653795575000000,7083.324667,0.06869871929872956,1,541808341759,6859.08,7569.94,0.1036378056532
1132,2020-04-26,7570.14,7700.59,7561.41,7679.87,7679.87,33070154491,BTC,100.0000000000000000000,7138.044000,0.07590678903072046,1,574878496250,6971.09,7679.87,0.1016742001610
1133,2020-04-27,7679.42,7795.60,7679.42,7795.60,7795.60,36162144725,BTC,100.0000000000000000000,7193.011333,0.08377418567873679,1,611040640975,6845.04,7795.60,0.1388684361231
1134,2020-04-28,7796.97,7814.53,7730.81,7807.06,7807.06,33187959921,BTC,100.0000000000000000000,7257.146000,0.07577551836493299,1,644228600896,6842.43,7807.06,0.1409776935972
1135,2020-04-29,7806.71,8871.75,7786.05,8801.04,8801.04,60201052203,BTC,100.0000000000000000000,7387.720000,0.19130665482719973,1,704429653099,6642.11,8801.04,0.3250367729532
1136,2020-04-30,8797.67,9440.65,8533.26,8658.55,8658.55,66964629541,BTC,98.1453569494772500000,7522.149333,0.15107393069352669,-1,637465023558,7116.80,8658.55,0.2166352855216
1137,2020-05-01,8672.78,9048.02,8667.76,8864.77,8864.77,44068389997,BTC,98.1453569494772500000,7638.680667,0.16051061517689178,1,681533413555,7096.18,8864.77,0.2492312765460
1138,2020-05-02,8869.06,9007.19,8811.37,8988.60,8988.60,40134388683,BTC,98.1453569494772500000,7764.842000,0.15760243415126798,1,721667802238,7257.67,8988.60,0.2384966525069
1139,2020-05-03,8983.61,9167.78,8830.97,8897.47,8897.47,47101785174,BTC,97.0647367282542500000,7874.162000,0.12995770216563998,-1,674566017064,7189.42,8897.47,0.2375782747426
1140,2020-05-04,8895.75,8956.91,8645.02,8912.65,8912.65,45718796276,BTC,98.0187641110290000000,7989.044000,0.11560907663044539,1,720284813340,6881.96,8912.65,0.2950743683486
1141,2020-05-05,8912.83,9062.42,8856.83,9003.07,9003.07,43148462663,BTC,98.0187641110290000000,8130.451333,0.10732721115471192,1,763433276003,6880.32,9003.07,0.3085248941910
1142,2020-05-06,9007.44,9411.47,8966.71,9268.76,9268.76,49371886931,BTC,98.0187641110290000000,8289.680667,0.11810820854626776,1,812805162934,7117.21,9268.76,0.3023024471668
1143,2020-05-07,9261.90,9992.66,9138.32,9951.52,9951.52,61112700562,BTC,99.0993843322520000000,8478.634667,0.17371727770423582,1,873917863496,7429.72,9951.52,0.3394205972769
1144,2020-05-08,9936.16,9996.74,9767.17,9842.67,9842.67,51780748042,BTC,98.8664386700102500000,8639.498000,0.13926411002120725,-1,822137115454,7550.90,9842.67,0.3035095154220
1145,2020-05-09,9840.91,9913.86,9580.64,9593.90,9593.90,46566121841,BTC,95.1124182297982500000,8775.698000,0.09323497686451836,-1,775570993613,7569.94,9593.90,0.2673680372632
1146,2020-05-10,9591.17,9595.58,8395.11,8756.43,8756.43,63325279337,BTC,81.9601940755492500000,8854.797333,-0.01110893104615791,-1,712245714276,7679.87,8756.43,0.1401794561627
1147,2020-05-11,8755.54,9033.47,8374.32,8601.80,8601.80,57119858802,BTC,66.3088712064260000000,8916.259333,-0.03526807837858119,-1,655125855474,7795.60,8601.80,0.1034173123300
1148,2020-05-12,8610.39,8949.90,8569.64,8804.48,8804.48,42142717533,BTC,54.0703015570550000000,8983.518000,-0.01992960886815165,1,697268573007,7807.06,8804.48,0.1277587209526
1149,2020-05-13,8805.39,9317.88,8805.39,9269.99,9269.99,45558144023,BTC,45.2007778547782500000,9081.046667,0.02080633873258346,1,742826717030,8801.04,9269.99,0.0532834755892
1150,2020-05-14,9271.33,9793.27,9255.04,9733.72,9733.72,56426907637,BTC,54.3188319589427500000,9143.225333,0.06458275340418103,1,799253624667,8658.55,9733.72,0.1241743709975
1151,2020-05-15,9734.29,9755.83,9261.40,9328.20,9328.20,48158802327,BTC,58.4247972724247500000,9187.868667,0.01527354581199305,-1,751094822340,8864.77,9328.20,0.0522777240695
1152,2020-05-16,9333.24,9564.21,9260.69,9377.01,9377.01,36164766408,BTC,61.1556470971757500000,9222.018000,0.01680673362381206,1,787259588748,8988.60,9377.01,0.0432114011081
1153,2020-05-17,9374.93,9823.00,9349.55,9670.74,9670.74,40084250663,BTC,68.5784829446107500000,9267.494000,0.04351187063083073,1,827343839411,8897.47,9670.74,0.0869089752480
1154,2020-05-18,9675.70,9906.03,9570.36,9726.58,9726.58,41827139896,BTC,68.4462332928312500000,9322.768000,0.04331460355980112,1,869170979307,8912.65,9726.58,0.0913230071864
1155,2020-05-19,9727.06,9836.05,9539.62,9729.04,9729.04,39254288955,BTC,75.8707361526837500000,9377.194000,0.03752145897802690,1,908425268262,9003.07,9729.04,0.0806358275566
1156,2020-05-20,9725.33,9804.79,9447.20,9522.98,9522.98,36546239703,BTC,78.5744450700887500000,9411.854667,0.01180695377603199,-1,871879028559,9268.76,9522.98,0.0274276170707
1157,2020-05-21,9522.74,9555.24,8869.93,9081.76,9081.76,39326160532,BTC,67.6651453634830000000,9399.388000,-0.03379241286773139,-1,832552868027,9951.52,9081.76,-0.0873997138126
1158,2020-05-22,9080.33,9232.94,9008.64,9182.58,9182.58,29810773699,BTC,58.5326296410077500000,9348.125333,-0.01770893383463797,1,862363641726,9842.67,9182.58,-0.0670641197968
1159,2020-05-23,9185.06,9302.50,9118.11,9209.29,9209.29,27727866812,BTC,51.0707311386907500000,9305.900000,-0.01038158587562729,1,890091508538,9593.90,9209.29,-0.0400890148949
1160,2020-05-24,9212.28,9288.40,8787.25,8790.37,8790.37,32518803300,BTC,38.1731295120182500000,9252.331333,-0.04992918177847101,-1,857572705238,8756.43,8790.37,0.0038760088301
1161,2020-05-25,8786.11,8951.01,8719.67,8906.93,8906.93,31288157264,BTC,36.0223505322657500000,9262.364667,-0.03837407398418942,1,888860862502,8601.80,8906.93,0.0354728080169
1162,2020-05-26,8909.59,8991.97,8757.29,8835.05,8835.05,29584186947,BTC,25.5053639764280000000,9277.914667,-0.04773321192263128,-1,859276675555,8804.48,8835.05,0.0034720960238
1163,2020-05-27,8837.38,9203.32,8834.16,9181.02,9181.02,32740536902,BTC,22.4408494584157500000,9303.017333,-0.01311373811669109,1,892017212457,9269.99,9181.02,-0.0095976371064
1164,2020-05-28,9184.95,9546.32,9148.46,9525.75,9525.75,34367073114,BTC,37.7645482600150000000,9320.068000,0.02206872310373701,1,926384285571,9733.72,9525.75,-0.0213659320383
1165,2020-05-29,9528.36,9573.67,9379.34,9439.12,9439.12,32896642044,BTC,48.3037717526610000000,9300.428000,0.01491243198700103,-1,893487643527,9328.20,9439.12,0.0118908256684
1166,2020-05-30,9438.91,9704.03,9366.73,9700.41,9700.41,32722975141,BTC,71.3571786849510000000,9325.242000,0.04023144922137141,1,926210618668,9377.01,9700.41,0.0344886056430
1167,2020-05-31,9700.11,9700.34,9432.30,9461.06,9461.06,27773290299,BTC,78.8672203258775000000,9330.845333,0.01395529154678788,-1,898437328369,9670.74,9461.06,-0.0216818981795
1168,2020-06-01,9463.61,10199.57,9450.90,10167.27,10167.27,35198901068,BTC,84.3786953881555000000,9363.947333,0.08578889205933128,1,933636229437,9726.58,10167.27,0.0453078060325
1169,2020-06-02,10162.97,10182.34,9460.57,9529.80,9529.80,39137252109,BTC,80.5258889154137500000,9350.828667,0.01913962274077457,-1,894498977328,9729.04,9529.80,-0.0204788961706
1170,2020-06-03,9533.76,9682.86,9471.85,9656.72,9656.72,25007459262,BTC,72.0184860317152500000,9346.007333,0.03324549788259833,1,919506436590,9522.98,9656.72,0.0140439232257
1171,2020-06-04,9655.85,9887.61,9525.25,9800.64,9800.64,25921805072,BTC,72.4989105962670000000,9364.518000,0.04657175094329468,1,945428241662,9081.76,9800.64,0.0791564630644
1172,2020-06-05,9800.22,9869.24,9663.22,9665.53,9665.53,23509628646,BTC,63.3889534461472500000,9403.436000,0.02787215226434252,-1,921918613016,9182.58,9665.53,0.0525941510991
1173,2020-06-06,9664.90,9773.43,9591.02,9653.68,9653.68,20438419222,BTC,65.6382090202630000000,9434.842667,0.02319459271593596,-1,901480193794,9209.29,9653.68,0.0482545342801
1174,2020-06-07,9653.00,9768.50,9458.15,9758.85,9758.85,25015250846,BTC,67.4925557411577500000,9471.480000,0.03034055923678242,1,926495444640,8790.37,9758.85,0.1101751120829
1175,2020-06-08,9760.06,9782.31,9675.89,9771.49,9771.49,21486346312,BTC,66.7222806428290000000,9536.888000,0.02459942908001017,1,947981790952,8906.93,9771.49,0.0970659924351
1176,2020-06-09,9774.36,9836.37,9664.72,9795.70,9795.70,23717842783,BTC,68.8594780385537500000,9596.139333,0.02079593262195915,1,971699633735,8835.05,9795.70,0.1087316993113
1177,2020-06-10,9794.12,9908.90,9728.29,9870.09,9870.09,25706567601,BTC,70.6515125780370000000,9665.142000,0.02120486175992034,1,997406201336,9181.02,9870.09,0.0750537521975
1178,2020-06-11,9870.08,9938.30,9263.07,9321.78,9321.78,30247143440,BTC,53.0670837887277500000,9674.526000,-0.03646132120581411,-1,967159057896,9525.75,9321.78,-0.0214124872057
1179,2020-06-12,9320.69,9540.47,9285.85,9480.84,9480.84,22610564515,BTC,40.1973502639277500000,9671.532000,-0.01971683493370027,1,989769622411,9439.12,9480.84,0.0044199035503
1180,2020-06-13,9480.74,9493.21,9396.01,9475.28,9475.28,17564322315,BTC,26.7088981766687500000,9673.942667,-0.02053585325429756,-1,972205300096,9700.41,9475.28,-0.0232082973812
1181,2020-06-14,9477.55,9482.27,9347.59,9386.79,9386.79,18991732746,BTC,11.1642361234315000000,9653.034667,-0.02758144730487582,-1,953213567350,9461.06,9386.79,-0.0078500717679
1182,2020-06-15,9386.04,9504.86,8990.18,9450.70,9450.70,26699704768,BTC,14.9762268033922500000,9652.344000,-0.02089067691744099,1,979913272118,10167.27,9450.70,-0.0704781126104
1183,2020-06-16,9454.27,9579.43,9400.45,9538.02,9538.02,21565537209,BTC,20.1324230508555000000,9610.394000,-0.00753080466836219,1,1001478809327,9529.80,9538.02,0.0008625574514
1184,2020-06-17,9533.78,9540.42,9327.34,9480.25,9480.25,20177709879,BTC,22.8190183434770000000,9607.090667,-0.01320281773083427,-1,981301099448,9656.72,9480.25,-0.0182743208874
1185,2020-06-18,9481.57,9482.78,9328.40,9411.84,9411.84,17770083003,BTC,25.0030140061812500000,9590.765333,-0.01865600155853589,-1,963531016445,9800.64,9411.84,-0.0396708786365
1186,2020-06-19,9410.29,9440.88,9274.30,9288.02,9288.02,19632223107,BTC,21.1910233262205000000,9556.590667,-0.02810318829783149,-1,943898793338,9665.53,9288.02,-0.0390573512265
1187,2020-06-20,9290.96,9394.97,9247.38,9332.34,9332.34,17130541557,BTC,13.2351883318070000000,9534.378000,-0.02119047514164007,1,961029334895,9653.68,9332.34,-0.0332867880435
1188,2020-06-21,9330.93,9401.11,9300.43,9303.63,9303.63,15324301169,BTC,6.6802568883300000000,9511.041333,-0.02180742630991992,-1,945705033726,9758.85,9303.63,-0.0466468897462
1189,2020-06-22,9300.92,9655.07,9296.87,9648.72,9648.72,21104009514,BTC,18.0661260673115000000,9503.699333,0.01525939130843924,1,966809043240,9771.49,9648.72,-0.0125641023017
1190,2020-06-23,9644.08,9670.54,9547.25,9629.66,9629.66,17006433272,BTC,32.7396189461747500000,9494.244000,0.01426295764043983,-1,949802609968,9795.70,9629.66,-0.0169502945170
1191,2020-06-24,9632.15,9680.37,9278.23,9313.61,9313.61,18961716076,BTC,31.9351624375072500000,9462.104667,-0.01569361914985885,-1,930840893892,9870.09,9313.61,-0.0563804382736
1192,2020-06-25,9314.13,9340.16,9095.32,9264.81,9264.81,18616048626,BTC,31.2647104300167500000,9421.752667,-0.01665748110218355,-1,912224845266,9321.78,9264.81,-0.0061114937276
1193,2020-06-26,9261.00,9310.52,9101.74,9162.92,9162.92,18341465837,BTC,15.7725874894770000000,9411.162000,-0.02637740164285770,-1,893883379429,9480.84,9162.92,-0.0335328937098
1194,2020-06-27,9167.82,9207.81,8998.22,9045.39,9045.39,17273093144,BTC,1.0990946106137500000,9382.132000,-0.03589184206745333,-1,876610286285,9475.28,9045.39,-0.0453696355147
1195,2020-06-28,9048.46,9197.55,8975.53,9143.58,9143.58,14560870760,BTC,4.0686688876735000000,9360.018667,-0.02312374309285125,1,891171157045,9386.79,9143.58,-0.0259098158156
1196,2020-06-29,9140.03,9237.57,9041.88,9190.85,9190.85,16460547078,BTC,10.0960502544215000000,9346.956000,-0.01670126616622567,1,907631704123,9450.70,9190.85,-0.0274953178071
1197,2020-06-30,9185.58,9217.84,9084.84,9137.99,9137.99,15735797744,BTC,13.9330880281107500000,9326.108667,-0.02017118540186532,-1,891895906379,9538.02,9137.99,-0.0419405704748
1198,2020-07-01,9145.99,9309.75,9104.74,9228.33,9228.33,15971550355,BTC,21.5135166492632500000,9305.462667,-0.00828896635881802,1,907867456734,9480.25,9228.33,-0.0265731388940
1199,2020-07-02,9231.14,9274.96,9036.62,9123.41,9123.41,16338916796,BTC,20.6777385510417500000,9281.673333,-0.01705116387120753,-1,891528539938,9411.84,9123.41,-0.0306454423365
1200,2020-07-03,9124.84,9202.34,9058.79,9087.30,9087.30,13078970999,BTC,16.3869689887787500000,9260.037333,-0.01865406442632967,-1,878449568939,9288.02,9087.30,-0.0216106339134
1201,2020-07-04,9084.23,9183.30,9053.63,9132.49,9132.49,12290528515,BTC,16.1590671771667500000,9249.668667,-0.01266841777998576,1,890740097454,9332.34,9132.49,-0.0214147791444
1202,2020-07-05,9126.09,9162.18,8977.02,9073.94,9073.94,12903406143,BTC,9.7616561417467500000,9232.442000,-0.01716793888334202,-1,877836691311,9303.63,9073.94,-0.0246882130953
1203,2020-07-06,9072.85,9375.47,9058.66,9375.47,9375.47,17889263252,BTC,20.2061889844695000000,9237.231333,0.01496537891241746,1,895725954563,9648.72,9375.47,-0.0283198185873
1204,2020-07-07,9349.16,9360.62,9201.82,9252.28,9252.28,13839652595,BTC,27.3220768804655000000,9210.802000,0.00450319092734813,-1,881886301968,9629.66,9252.28,-0.0391893379413
1205,2020-07-08,9253.02,9450.34,9249.50,9428.33,9428.33,19702359883,BTC,48.7129409183882500000,9197.380000,0.02511041187816530,1,901588661851,9313.61,9428.33,0.0123174579996
1206,2020-07-09,9427.99,9431.38,9235.00,9277.97,9277.97,18000702524,BTC,62.7137641432265000000,9195.004000,0.00902294332879029,-1,883587959327,9264.81,9277.97,0.0014204284815
1207,2020-07-10,9273.36,9287.47,9118.00,9278.81,9278.81,16860035605,BTC,64.2750201997757500000,9195.937333,0.00901187818044475,1,900447994932,9162.92,9278.81,0.0126477149206
1208,2020-07-11,9277.51,9293.53,9199.49,9240.35,9240.35,13249910444,BTC,68.1503629811457500000,9201.099333,0.00426586710777335,-1,887198084488,9045.39,9240.35,0.0215535206332
1209,2020-07-12,9241.05,9319.42,9197.45,9276.50,9276.50,14452361907,BTC,57.4397052312092500000,9216.506667,0.00650933538786535,1,901650446395,9143.58,9276.50,0.0145369756704
1210,2020-07-13,9277.21,9306.41,9224.29,9243.61,9243.61,17519821266,BTC,54.2250226925987500000,9223.175333,0.00221557828645910,-1,884130625129,9190.85,9243.61,0.0057404919023
1211,2020-07-14,9238.70,9283.84,9171.66,9243.21,9243.21,18085038362,BTC,50.9272837753412500000,9226.666000,0.00179306371337166,1,902215663491,9137.99,9243.21,0.0115145672079
1212,2020-07-15,9241.90,9275.33,9171.93,9192.84,9192.84,15844731575,BTC,46.5870933152742500000,9230.322667,-0.00406081871157192,-1,886370931916,9228.33,9192.84,-0.0038457662437
1213,2020-07-16,9191.98,9214.31,9088.95,9132.23,9132.23,15713967523,BTC,36.4097463246707500000,9223.916000,-0.00994002980946487,-1,870656964393,9123.41,9132.23,0.0009667437943
1214,2020-07-17,9131.81,9182.25,9089.20,9151.39,9151.39,13944570749,BTC,29.9042015858237500000,9225.781333,-0.00806341818810589,1,884601535142,9087.30,9151.39,0.0070526999219
1215,2020-07-18,9151.18,9230.98,9100.82,9159.04,9159.04,12252601475,BTC,23.9665340444145000000,9230.564000,-0.00774860561066474,1,896854136617,9132.49,9159.04,0.0029072027454
1216,2020-07-19,9158.01,9201.40,9097.63,9185.82,9185.82,12939002784,BTC,23.4713169107480000000,9234.119333,-0.00523052943743022,1,909793139401,9073.94,9185.82,0.0123298148324
1217,2020-07-20,9187.22,9214.27,9137.51,9164.23,9164.23,13755604146,BTC,22.0611115871205000000,9240.138667,-0.00821510041522410,-1,896037535255,9375.47,9164.23,-0.0225311371057
1218,2020-07-21,9162.51,9407.26,9149.39,9374.89,9374.89,18069581956,BTC,37.0855088611670000000,9240.100000,0.01458750446423740,1,914107117211,9252.28,9374.89,0.0132518687286
1219,2020-07-22,9375.08,9530.52,9319.65,9525.36,9525.36,16532254884,BTC,56.0822356311097500000,9258.305333,0.02884487575151784,1,930639372095,9428.33,9525.36,0.0102913241263
1220,2020-07-23,9527.14,9610.25,9483.00,9581.07,9581.07,18146399002,BTC,73.1898007429922500000,9268.488000,0.03372524191648088,1,948785771097,9277.97,9581.07,0.0326687842276
1221,2020-07-24,9585.51,9623.34,9481.45,9536.89,9536.89,16552768325,BTC,93.0272229985865000000,9285.749333,0.02704581590496828,-1,932233002772,9278.81,9536.89,0.0278139114822
1222,2020-07-25,9539.49,9704.56,9530.21,9677.11,9677.11,16610070933,BTC,97.5392121914267500000,9312.302667,0.03917477191680716,1,948843073705,9240.35,9677.11,0.0472666078666
1223,2020-07-26,9680.23,10023.81,9652.85,9905.17,9905.17,20507998997,BTC,97.5392121914267500000,9356.624000,0.05862648750232990,1,969351072702,9276.50,9905.17,0.0677701719398
1224,2020-07-27,9905.22,11298.22,9903.97,10990.87,10990.87,35359749590,BTC,97.5392121914267500000,9470.915333,0.16048656476781535,1,1004710822292,9243.61,10990.87,0.1890235524865
1225,2020-07-28,11017.46,11204.33,10632.63,10912.82,10912.82,28766551142,BTC,98.9501732449532500000,9582.196000,0.13886420190110910,-1,975944271150,9243.21,10912.82,0.1806309712751
1226,2020-07-29,10912.95,11304.40,10856.14,11100.47,11100.47,24617249715,BTC,98.9501732449532500000,9706.013333,0.14366935415789213,1,1000561520865,9192.84,11100.47,0.2075125858821
1227,2020-07-30,11099.83,11169.36,10895.46,11111.21,11111.21,22857247901,BTC,98.9501732449532500000,9833.904667,0.12988791088104617,1,1023418768766,9132.23,11111.21,0.2167028206692
1228,2020-07-31,11110.21,11415.86,10987.05,11323.47,11323.47,23160469766,BTC,98.9501732449532500000,9979.987333,0.13461767256533651,1,1046579238532,9151.39,11323.47,0.2373497359418
1229,2020-08-01,11322.57,11794.78,11239.68,11759.59,11759.59,26075670303,BTC,100.0000000000000000000,10153.867333,0.15813902371773287,1,1072654908835,9159.04,11759.59,0.2839325955559
1230,2020-08-02,11758.76,12034.14,11018.13,11053.61,11053.61,27410067336,BTC,93.1995946612415000000,10280.172000,0.07523590072228363,-1,1045244841499,9185.82,11053.61,0.2033340518321
1231,2020-08-03,11043.77,11453.08,11012.42,11246.35,11246.35,20271713443,BTC,88.2557718389740000000,10417.540667,0.07955902064538588,1,1065516554942,9164.23,11246.35,0.2272007577287
1232,2020-08-04,11246.20,11385.38,11094.15,11205.89,11205.89,21250197042,BTC,82.4510584578360000000,10553.651333,0.06180218072588091,-1,1044266357900,9374.89,11205.89,0.1953089582918
1233,2020-08-05,11203.82,11786.62,11158.29,11747.02,11747.02,24411254471,BTC,82.3104059735350000000,10711.793333,0.09664363704728694,1,1068677612371,9525.36,11747.02,0.2332363291256
1234,2020-08-06,11749.87,11902.34,11598.71,11779.77,11779.77,23400740340,BTC,89.1108113122935000000,10862.087333,0.08448492806829102,1,1092078352711,9581.07,11779.77,0.2294837632957
1235,2020-08-07,11778.89,11898.04,11408.59,11601.47,11601.47,23132312867,BTC,92.0672340061547500000,10996.780667,0.05498785065474654,-1,1068946039844,9536.89,11601.47,0.2164835706399
1236,2020-08-08,11604.55,11800.06,11558.43,11754.05,11754.05,17572057837,BTC,97.5661442617280000000,11144.591333,0.05468649758339237,1,1086518097681,9677.11,11754.05,0.2146239941470
1237,2020-08-09,11737.33,11806.06,11548.78,11675.74,11675.74,17489608833,BTC,96.3194341086662500000,11277.833333,0.03528219075872381,-1,1069028488848,9905.17,11675.74,0.1787521062233
1238,2020-08-10,11662.26,12045.14,11662.26,11878.11,11878.11,26114112569,BTC,96.3194341086662500000,11409.362667,0.04108444500197953,1,1095142601417,10990.87,11878.11,0.0807251837207
1239,2020-08-11,11881.65,11932.71,11195.71,11410.53,11410.53,27039782640,BTC,86.1970019586897500000,11437.340000,-0.00234407650729977,-1,1068102818777,10912.82,11410.53,0.0456078263913
1240,2020-08-12,11404.60,11748.40,11249.61,11584.93,11584.93,25064548486,BTC,77.6131750054187500000,11482.147333,0.00895151960858400,1,1093167367263,11100.47,11584.93,0.0436431970899
1241,2020-08-13,11588.41,11796.40,11216.87,11784.14,11784.14,27522199497,BTC,76.1512350351405000000,11527.725333,0.02224330122317983,1,1120689566760,11111.21,11784.14,0.0605631609879
1242,2020-08-14,11772.66,12150.99,11685.46,11768.87,11768.87,24237958589,BTC,72.8389245439337500000,11571.569333,0.01705046751414560,-1,1096451608171,11323.47,11768.87,0.0393342323510
1243,2020-08-15,11768.70,11963.20,11768.70,11865.70,11865.70,23354924400,BTC,84.5724681625227500000,11607.718000,0.02222504027061994,1,1119806532571,11759.59,11865.70,0.0090232737706
1244,2020-08-16,11866.69,11934.90,11737.19,11892.80,11892.80,20583375490,BTC,93.4620982413585000000,11616.598667,0.02377643757157785,1,1140389908061,11053.61,11892.80,0.0759199935587
1245,2020-08-17,11895.66,12359.06,11806.70,12254.40,12254.40,28227687027,BTC,96.3114008489995000000,11696.651333,0.04768447405339102,1,1168617595088,11246.35,12254.40,0.0896335255438
1246,2020-08-18,12251.90,12335.71,11954.53,11991.23,11991.23,26043227672,BTC,93.3488546387917500000,11746.310000,0.02085080335867179,-1,1142574367416,11205.89,11991.23,0.0700827868201
1247,2020-08-19,11990.88,12028.92,11687.33,11758.28,11758.28,24502851117,BTC,79.0273817950365000000,11783.136000,-0.00210945541153051,-1,1118071516299,11747.02,11758.28,0.0009585409746
1248,2020-08-20,11761.50,11900.41,11710.06,11878.37,11878.37,20175242945,BTC,67.8873365274005000000,11791.892667,0.00733362619912660,1,1138246759244,11779.77,11878.37,0.0083702822721
1249,2020-08-21,11878.03,11899.26,11564.98,11592.49,11592.49,23762425999,BTC,48.2779772659030000000,11779.407333,-0.01586814410232264,-1,1114484333245,11601.47,11592.49,-0.0007740398415
1250,2020-08-22,11585.48,11689.41,11448.81,11681.83,11681.83,20224191306,BTC,37.5902093924422500000,11784.764667,-0.00873455430877125,1,1134708524551,11754.05,11681.83,-0.0061442651682
1251,2020-08-23,11679.70,11713.43,11559.92,11664.85,11664.85,18482062658,BTC,34.8223067534100000000,11778.818000,-0.00967567373907976,-1,1116226461893,11675.74,11664.85,-0.0009327031948
1252,2020-08-24,11663.69,11807.63,11623.25,11774.60,11774.60,20681511755,BTC,31.7480773104862500000,11785.408667,-0.00091712280035440,1,1136907973648,11878.11,11774.60,-0.0087143493367
1253,2020-08-25,11773.59,11778.30,11189.85,11366.13,11366.13,26301509932,BTC,26.3574365719837500000,11751.276667,-0.03277487867182729,-1,1110606463716,11410.53,11366.13,-0.0038911426551
1254,2020-08-26,11366.89,11530.05,11296.99,11488.36,11488.36,22466660958,BTC,21.7601750761822500000,11756.465333,-0.02280492694070533,1,1133073124674,11584.93,11488.36,-0.0083358293921
1255,2020-08-27,11485.61,11570.79,11185.94,11323.40,11323.40,23240415076,BTC,14.2258392187635000000,11739.030000,-0.03540582143499080,-1,1109832709598,11784.14,11323.40,-0.0390983134959
1256,2020-08-28,11325.30,11545.62,11316.42,11542.50,11542.50,19807127588,BTC,9.3235725759397500000,11722.920667,-0.01539041951447167,1,1129639837186,11768.87,11542.50,-0.0192346418985
1257,2020-08-29,11541.05,11585.64,11466.29,11506.87,11506.87,17485597759,BTC,14.2502643052630000000,11705.454000,-0.01696508311424743,-1,1112154239427,11865.70,11506.87,-0.0302409465940
1258,2020-08-30,11508.71,11715.26,11492.38,11711.51,11711.51,19760127945,BTC,21.2320085929107500000,11695.174667,0.00139675836104381,1,1131914367372,11892.80,11711.51,-0.0152436768465
1259,2020-08-31,11713.31,11768.88,11598.32,11680.82,11680.82,22285928250,BTC,30.8297529538130000000,11681.042667,-0.00001906225380283,-1,1109628439122,12254.40,11680.82,-0.0468060451756
1260,2020-09-01,11679.32,12067.08,11601.13,11970.48,11970.48,27311555343,BTC,49.1695247700387500000,11662.114667,0.02644163102533830,1,1136939994465,11991.23,11970.48,-0.0017304313236
1261,2020-09-02,11964.82,11964.82,11290.79,11414.03,11414.03,28037405299,BTC,47.7443320825650000000,11623.634667,-0.01803262688520973,-1,1108902589166,11758.28,11414.03,-0.0292772412292
1262,2020-09-03,11407.19,11443.02,10182.46,10245.30,10245.30,31927261555,BTC,37.3224738655940000000,11522.769333,-0.11086478398395619,-1,1076975327611,11878.37,10245.30,-0.1374826680765
1263,2020-09-04,10230.37,10663.92,10207.94,10511.81,10511.81,29965130374,BTC,31.5867902751620000000,11431.665333,-0.08046555827213001,1,1106940457985,11592.49,10511.81,-0.0932224224476
1264,2020-09-05,10512.53,10581.57,9946.68,10169.57,10169.57,44916565292,BTC,7.3635598123197500000,11336.804000,-0.10295970539845269,-1,1062023892693,11681.83,10169.57,-0.1294540324590
1265,2020-09-06,10167.22,10353.93,10056.89,10280.35,10280.35,37071460174,BTC,5.3998944212357500000,11243.372000,-0.08565241815355749,1,1099095352867,11664.85,10280.35,-0.1186899102860
1266,2020-09-07,10281.00,10399.15,9916.49,10369.56,10369.56,33703098409,BTC,8.1761297689210000000,11157.019333,-0.07057972290779036,1,1132798451276,11774.60,10369.56,-0.1193280451141
1267,2020-09-08,10369.31,10414.78,9945.11,10131.52,10131.52,33430927462,BTC,4.3140689984507500000,11047.480667,-0.08291127132144001,-1,1099367523814,11366.13,10131.52,-0.1086218440225
1268,2020-09-09,10134.15,10350.54,10017.25,10242.35,10242.35,24128292755,BTC,5.8207629994077500000,10972.562000,-0.06654890626273062,1,1123495816569,11488.36,10242.35,-0.1084584744907
1269,2020-09-10,10242.33,10503.91,10238.14,10363.14,10363.14,54406443211,BTC,7.4317199694280000000,10897.547333,-0.04903923026621829,1,1177902259780,11323.40,10363.14,-0.0848031509971
1270,2020-09-11,10369.03,10434.92,10140.84,10400.92,10400.92,45201121775,BTC,8.3178807586897500000,10836.048667,-0.04015565824516244,1,1223103381555,11542.50,10400.92,-0.0989023175222
1271,2020-09-12,10409.86,10578.84,10292.39,10442.17,10442.17,36750077324,BTC,12.5410558141560000000,10762.693333,-0.02978095938283667,1,1259853458879,11506.87,10442.17,-0.0925273336711
1272,2020-09-13,10452.40,10577.21,10224.33,10323.76,10323.76,36506852789,BTC,13.6477954931050000000,10683.819333,-0.03370136856281862,-1,1223346606090,11711.51,10323.76,-0.1184945408406
1273,2020-09-14,10328.73,10800.01,10266.01,10680.84,10680.84,35453581940,BTC,17.9668127637362500000,10615.108000,0.00619230628647396,1,1258800188030,11680.82,10680.84,-0.0856087158265
1274,2020-09-15,10677.75,10938.63,10656.46,10796.95,10796.95,32509451925,BTC,23.3506982207337500000,10556.183333,0.02280811723374793,1,1291309639955,11970.48,10796.95,-0.0980353335873
1275,2020-09-16,10797.76,11100.12,10704.88,10974.91,10974.91,30769986455,BTC,35.5677458535895000000,10489.812000,0.04624468007624922,1,1322079626410,11414.03,10974.91,-0.0384719507483
1276,2020-09-17,10973.25,11037.42,10774.63,10948.99,10948.99,38151810523,BTC,57.1859843538137500000,10458.809333,0.04686773143988435,-1,1283927815887,10245.30,10948.99,0.0686841771349
1277,2020-09-18,10951.82,11034.91,10829.66,10944.59,10944.59,26341903912,BTC,73.8194226237220000000,10505.428667,0.04180327589863211,-1,1257585911975,10511.81,10944.59,0.0411708354698
1278,2020-09-19,10933.75,11134.09,10909.62,11094.35,11094.35,22764204008,BTC,89.7731410297775000000,10544.264667,0.05216915075373458,1,1280350115983,10169.57,11094.35,0.0909359982772
1279,2020-09-20,11095.87,11095.87,10814.48,10938.27,10938.27,24699523788,BTC,94.2802818428005000000,10595.511333,0.03234942196064376,-1,1255650592195,10280.35,10938.27,0.0639978210859
1280,2020-09-21,10934.93,10988.30,10380.26,10462.26,10462.26,28884999244,BTC,78.6363146573215000000,10607.638667,-0.01370509229846488,-1,1226765592951,10369.56,10462.26,0.0089396271394
1281,2020-09-22,10459.62,10568.08,10382.73,10538.46,10538.46,23621787804,BTC,65.1013159124665000000,10618.898667,-0.00757504798967303,1,1250387380755,10131.52,10538.46,0.0401657401851
1282,2020-09-23,10535.49,10537.83,10197.87,10246.19,10246.19,23788661867,BTC,40.2139919688045000000,10626.543333,-0.03579276167997536,-1,1226598718888,10242.35,10246.19,0.0003749139602
1283,2020-09-24,10248.79,10771.06,10231.49,10760.07,10760.07,47144380902,BTC,34.4135347115645000000,10661.058000,0.00928725835653460,1,1273743099790,10363.14,10760.07,0.0383020976268
1284,2020-09-25,10761.11,10777.70,10578.91,10692.72,10692.72,39348590957,BTC,38.9875562779395000000,10683.030000,0.00090704603469240,-1,1234394508833,10400.92,10692.72,0.0280552105006
1285,2020-09-26,10695.58,10773.00,10667.28,10750.72,10750.72,46852525493,BTC,43.2926185200242500000,10706.350000,0.00414426952229284,1,1281247034326,10442.17,10750.72,0.0295484559244
1286,2020-09-27,10746.89,10803.98,10622.92,10775.27,10775.27,53745972818,BTC,58.7748773816262500000,10728.556667,0.00435411159673376,1,1334993007144,10323.76,10775.27,0.0437350345223
1287,2020-09-28,10776.61,10945.35,10703.89,10709.65,10709.65,47762394731,BTC,57.2887191096020000000,10754.282667,-0.00415022260266204,-1,1287230612413,10680.84,10709.65,0.0026973533917
1288,2020-09-29,10709.65,10860.00,10649.50,10844.64,10844.64,46582396602,BTC,61.7666478023015000000,10765.202667,0.00737908383680595,1,1333813009015,10796.95,10844.64,0.0044169881309
1289,2020-09-30,10843.87,10847.26,10669.32,10784.49,10784.49,44171073700,BTC,62.7620378230522500000,10764.372000,0.00186894321377968,-1,1289641935315,10974.91,10784.49,-0.0173504839675
1290,2020-10-01,10795.25,10933.62,10472.36,10619.45,10619.45,40023134100,BTC,58.1691544048292500000,10740.674667,-0.01128650394490158,-1,1249618801215,10948.99,10619.45,-0.0300977533088
1291,2020-10-02,10619.82,10657.84,10416.69,10575.97,10575.97,48661453918,BTC,54.2288601207320000000,10715.806667,-0.01304956979399748,-1,1200957347297,10944.59,10575.97,-0.0336805672940
1292,2020-10-03,10575.10,10598.94,10511.13,10549.33,10549.33,44660271563,BTC,45.5244293529522500000,10689.456000,-0.01310880553697026,-1,1156297075734,11094.35,10549.33,-0.0491259064298
1293,2020-10-04,10550.44,10686.00,10534.39,10669.58,10669.58,71251776995,BTC,44.9518430709415000000,10661.138000,0.00079184792467746,1,1227548852729,10938.27,10669.58,-0.0245642135365
1294,2020-10-05,10676.53,10793.51,10634.60,10793.34,10793.34,47537578009,BTC,56.8067553944345000000,10651.476000,0.01331871751858616,1,1275086430738,10462.26,10793.34,0.0316451703552
1295,2020-10-06,10796.31,10797.58,10528.89,10604.41,10604.41,42623695307,BTC,62.0507933097595000000,10660.952667,-0.00530371616553769,-1,1232462735431,10538.46,10604.41,0.0062580301107
1296,2020-10-07,10603.36,10680.51,10562.51,10668.97,10668.97,37799458436,BTC,70.7770275922987500000,10669.653333,-0.00006404453628184,1,1270262193867,10246.19,10668.97,0.0412621667176
1297,2020-10-08,10669.37,10945.74,10562.61,10915.69,10915.69,63314794397,BTC,80.4829141950037500000,10714.286667,0.01879764274184694,1,1333576988264,10760.07,10915.69,0.0144627311904
1298,2020-10-09,10927.91,11102.67,10846.85,11064.46,11064.46,22799117613,BTC,82.6259503717937500000,10734.579333,0.03073065620614385,1,1356376105877,10692.72,11064.46,0.0347657097539
1299,2020-10-10,11059.14,11442.21,11056.94,11296.36,11296.36,22877978588,BTC,92.6614587684852500000,10774.822000,0.04840339821855062,1,1379254084465,10750.72,11296.36,0.0507538099774
1300,2020-10-11,11296.08,11428.81,11288.63,11384.18,11384.18,19968627060,BTC,100.0000000000000000000,10817.052667,0.05242900727756991,1,1399222711525,10775.27,11384.18,0.0565099528829
1301,2020-10-12,11392.64,11698.47,11240.69,11555.36,11555.36,26163972642,BTC,100.0000000000000000000,10869.058667,0.06314266525064475,1,1425386684167,10709.65,11555.36,0.0789670997652
1302,2020-10-13,11548.72,11548.98,11321.22,11425.90,11425.90,24241420251,BTC,96.7828991183165000000,10916.808667,0.04663371398446439,-1,1401145263916,10844.64,11425.90,0.0535988285457
1303,2020-10-14,11429.05,11539.98,11307.83,11429.51,11429.51,24103426719,BTC,93.6555072910350000000,10955.800000,0.04323828474415378,1,1425248690635,10784.49,11429.51,0.0598099678334
1304,2020-10-15,11426.60,11569.91,11303.60,11495.35,11495.35,24487233058,BTC,92.1642495750622500000,11003.190667,0.04472878348605281,1,1449735923693,10619.45,11495.35,0.0824807311113
1305,2020-10-16,11502.83,11540.06,11223.01,11322.12,11322.12,25635480772,BTC,86.3681997554742500000,11050.035333,0.02462296805399726,-1,1424100442921,10575.97,11322.12,0.0705514482360
1306,2020-10-17,11322.12,11386.26,11285.35,11358.10,11358.10,19130430174,BTC,84.6833593431605000000,11102.177333,0.02305157441858707,1,1443230873095,10549.33,11358.10,0.0766655323134
1307,2020-10-18,11355.98,11483.36,11347.58,11483.36,11483.36,18283314340,BTC,85.9179071723347500000,11164.446000,0.02856514331297764,1,1461514187435,10669.58,11483.36,0.0762710434713
1308,2020-10-19,11495.04,11799.09,11408.29,11742.04,11742.04,23860769928,BTC,87.4091648883075000000,11235.943333,0.04504265035883481,1,1485374957363,10793.34,11742.04,0.0878967956166
1309,2020-10-20,11745.97,11999.92,11681.48,11916.33,11916.33,30915821592,BTC,93.2052147078955000000,11310.809333,0.05353468962060524,1,1516290778955,10604.41,11916.33,0.1237145678072
1310,2020-10-21,11913.08,13184.57,11900.93,12823.69,12823.69,43414712626,BTC,98.1071560018927500000,11458.761333,0.11911659797548556,1,1559705491581,10668.97,12823.69,0.2019613889626
1311,2020-10-22,12801.64,13161.59,12717.09,12965.89,12965.89,34729759598,BTC,100.0000000000000000000,11611.889333,0.11660468233640890,1,1594435251179,10915.69,12965.89,0.1878213837146
1312,2020-10-23,12971.55,13015.96,12752.65,12931.54,12931.54,28974975003,BTC,99.5483662296272500000,11746.279333,0.10090520014028003,-1,1565460276176,11064.46,12931.54,0.1687456956779
1313,2020-10-24,12931.57,13145.07,12885.75,13108.06,13108.06,24542317940,BTC,99.5483662296272500000,11882.519333,0.10313811681302652,1,1590002594116,11296.36,13108.06,0.1603790955671
1314,2020-10-25,13108.06,13329.18,12910.06,13031.17,13031.17,24406920575,BTC,98.4720422769747500000,11998.173333,0.08609616133472807,-1,1565595673541,11384.18,13031.17,0.1446735733272
1315,2020-10-26,13031.20,13225.30,12822.38,13075.25,13075.25,29461458313,BTC,98.0127603302127500000,12110.911333,0.07962560706495761,1,1595057131854,11555.36,13075.25,0.1315311682198
1316,2020-10-27,13075.24,13759.67,13060.84,13654.22,13654.22,33749878156,BTC,98.4643941005855000000,12250.835333,0.11455420213017731,1,1628807010010,11425.90,13654.22,0.1950235867634
1317,2020-10-28,13654.21,13837.70,12932.25,13271.29,13271.29,35867318895,BTC,94.3594028909460000000,12373.861333,0.07252616162803091,-1,1592939691115,11429.51,13271.29,0.1611425161709
1318,2020-10-29,13271.30,13612.05,12980.06,13437.88,13437.88,56499499598,BTC,93.1165724334102500000,12507.752667,0.07436406505335000,1,1649439190713,11495.35,13437.88,0.1689839804791
1319,2020-10-30,13437.87,13651.52,13136.20,13546.52,13546.52,30581485201,BTC,92.4213155525062500000,12644.497333,0.07133717088506740,1,1680020675914,11322.12,13546.52,0.1964649729909
1320,2020-10-31,13546.53,14028.21,13457.53,13781.00,13781.00,30306464719,BTC,92.4213155525062500000,12808.422667,0.07593263888033435,1,1710327140633,11358.10,13781.00,0.2133191290797
1321,2020-11-01,13781.00,13862.03,13628.38,13737.11,13737.11,24453857900,BTC,96.0487515315612500000,12967.023333,0.05938808369691086,-1,1685873282733,11483.36,13737.11,0.1962622438032
1322,2020-11-02,13737.03,13808.32,13243.16,13550.49,13550.49,30771455468,BTC,95.5415876226065000000,13104.832000,0.03400715095012282,-1,1655101827265,11742.04,13550.49,0.1540149752513
1323,2020-11-03,13550.45,13984.98,13325.44,13950.30,13950.30,29869951617,BTC,96.6961264502725000000,13252.049333,0.05269001415963866,1,1684971778882,11916.33,13950.30,0.1706876194265
1324,2020-11-04,13950.49,14218.77,13580.47,14133.71,14133.71,35116364962,BTC,96.6961264502725000000,13399.874667,0.05476434304323930,1,1720088143844,12823.69,14133.71,0.1021562436397
1325,2020-11-05,14133.73,15706.40,14102.09,15579.85,15579.85,40856321439,BTC,97.1736816808570000000,13583.618667,0.14695872888788008,1,1760944465283,12965.89,15579.85,0.2016028209402
1326,2020-11-06,15579.73,15903.44,15226.84,15565.88,15565.88,39837841971,BTC,99.8681234447630000000,13756.951333,0.13149197254632754,-1,1721106623312,12931.54,15565.88,0.2037143294611
1327,2020-11-07,15565.88,15737.10,14423.20,14833.75,14833.75,35024953706,BTC,92.5496291653712500000,13883.765333,0.06842413741623848,-1,1686081669606,13108.06,14833.75,0.1316510604926
1328,2020-11-08,14833.75,15637.32,14744.11,15479.57,15479.57,26632075029,BTC,91.5659827287845000000,14041.866000,0.10238696196075365,1,1712713744635,13031.17,15479.57,0.1878879640124
1329,2020-11-09,15479.60,15785.14,14865.53,15332.32,15332.32,34149115566,BTC,89.0952289158005000000,14195.276000,0.08010016853494078,-1,1678564629069,13075.25,15332.32,0.1726215559932
1330,2020-11-10,15332.35,15450.33,15124.96,15290.90,15290.90,25574938143,BTC,86.0979903516557500000,14342.986000,0.06608902776590593,-1,1652989690926,13654.22,15290.90,0.1198662391554
1331,2020-11-11,15290.91,15916.26,15290.01,15701.34,15701.34,29772374934,BTC,93.4164846310475000000,14479.460667,0.08438707498165132,1,1682762065860,13271.29,15701.34,0.1831057870034
1332,2020-11-12,15701.30,16305.00,15534.77,16276.34,16276.34,34175758344,BTC,94.4001310676342500000,14679.797333,0.10875781393868375,1,1716937824204,13437.88,16276.34,0.2112282592195
1333,2020-11-13,16276.44,16463.18,15992.15,16317.81,16317.81,31599492172,BTC,96.8708848806182500000,14871.792667,0.09723221439259727,1,1748537316376,13546.52,16317.81,0.2045757877300
1334,2020-11-14,16317.81,16317.81,15749.19,16068.14,16068.14,27481710135,BTC,97.7444784123267500000,15039.900667,0.06836742846687313,-1,1721055606241,13781.00,16068.14,0.1659632827806
1335,2020-11-15,16068.14,16123.11,15793.53,15955.59,15955.59,23653867583,BTC,94.4721788589682500000,15184.873333,0.05075555456396641,-1,1697401738658,13737.11,15955.59,0.1614953945917
1336,2020-11-16,15955.58,16816.18,15880.71,16716.11,16716.11,31526766675,BTC,94.4721788589682500000,15383.473333,0.08662781402827163,1,1728928505333,13550.49,16716.11,0.2336166441214
1337,2020-11-17,16685.69,17782.92,16564.54,17645.41,17645.41,39006849170,BTC,94.4721788589682500000,15656.468000,0.12703644270214713,1,1767935354503,13950.30,17645.41,0.2648767410020
1338,2020-11-18,17645.19,18393.95,17352.91,17804.01,17804.01,49064800278,BTC,96.7277004466415000000,15913.382000,0.11880742886710066,1,1817000154781,14133.71,17804.01,0.2596841169091
1339,2020-11-19,17803.86,18119.55,17382.55,17817.09,17817.09,36985055355,BTC,100.0000000000000000000,16158.940667,0.10261497750197785,1,1853985210136,15579.85,17817.09,0.1435983016525
1340,2020-11-20,17817.08,18773.23,17765.79,18621.31,18621.31,36992873940,BTC,100.0000000000000000000,16361.704667,0.13810329540768504,1,1890978084076,15565.88,18621.31,0.1962902193773
1341,2020-11-21,18621.32,18936.62,18444.36,18642.23,18642.23,39650210707,BTC,100.0000000000000000000,16566.794667,0.12527681876411102,1,1930628294783,14833.75,18642.23,0.2567442487571
1342,2020-11-22,18642.23,18688.97,17671.38,18370.00,18370.00,41280434226,BTC,97.9692390782167500000,16802.544667,0.09328678269062803,-1,1889347860557,15479.57,18370.00,0.1867254710564
1343,2020-11-23,18370.02,18711.43,18000.80,18364.12,18364.12,42741112308,BTC,95.8946149737567500000,16994.848000,0.08056982916234379,-1,1846606748249,15332.32,18364.12,0.1977391549355
1344,2020-11-24,18365.02,19348.27,18128.66,19107.46,19107.46,51469565009,BTC,95.8946149737567500000,17246.524000,0.10790209087929834,1,1898076313258,15290.90,19107.46,0.2495968190231
1345,2020-11-25,19104.41,19390.96,18581.15,18732.12,18732.12,43710357371,BTC,93.1397208420175000000,17475.938667,0.07188062151831996,-1,1854365955887,15701.34,18732.12,0.1930268371999
1346,2020-11-26,18729.84,18866.29,16351.04,17150.62,17150.62,61396835737,BTC,79.6492197828180000000,17572.557333,-0.02401115130850261,-1,1792969120150,16276.34,17150.62,0.0537147786296
1347,2020-11-27,17153.91,17445.02,16526.42,17108.40,17108.40,38886494645,BTC,65.8677013433280000000,17628.028000,-0.02947737546139591,-1,1754082625505,16317.81,17108.40,0.0484495162035
1348,2020-11-28,17112.93,17853.94,16910.65,17717.41,17717.41,32601040734,BTC,54.8421038408930000000,17721.334667,-0.00022146565559243,1,1786683666239,16068.14,17717.41,0.1026422473292
1349,2020-11-29,17719.63,18283.63,17559.12,18177.48,18177.48,31133957704,BTC,50.2205833362417500000,17861.957333,0.01766450681287158,1,1817817623943,15955.59,18177.48,0.1392546436703
1350,2020-11-30,18178.32,19749.26,18178.32,19625.84,19625.84,47728480399,BTC,65.7418453172245000000,18106.640667,0.08390288187299122,1,1865546104342,16716.11,19625.84,0.1740674116167
1351,2020-12-01,19633.77,19845.97,18321.92,18803.00,18803.00,49633658712,BTC,73.4265915220362500000,18245.766667,0.03054041757575656,-1,1815912445630,17645.41,18803.00,0.0656028961639
1352,2020-12-02,18801.74,19308.33,18347.72,19201.09,19201.09,37387697139,BTC,80.2341143136540000000,18349.478667,0.04641065549897892,1,1853300142769,17804.01,19201.09,0.0784699626657
1353,2020-12-03,19205.93,19566.19,18925.79,19445.40,19445.40,31930317405,BTC,85.8186292424050000000,18458.904667,0.05344278822586976,1,1885230460174,17817.09,19445.40,0.0913903448880
1354,2020-12-04,19446.97,19511.40,18697.19,18699.77,18699.77,33872388058,BTC,76.6220843396467500000,18517.750000,0.00982948792374884,-1,1851358072116,18621.31,18699.77,0.0042134522222
1355,2020-12-05,18698.38,19160.45,18590.19,19154.23,19154.23,27242455064,BTC,80.1100522753275000000,18553.278000,0.03239061043552519,1,1878600527180,18642.23,19154.23,0.0274645254350
1356,2020-12-06,19154.18,19390.50,18897.89,19345.12,19345.12,25293775714,BTC,81.5403743485447500000,18600.137333,0.04005253583145681,1,1903894302894,18370.00,19345.12,0.0530821992379
1357,2020-12-07,19343.13,19411.83,18931.14,19191.63,19191.63,26896357742,BTC,79.0202547031907500000,18654.912667,0.02877083064288140,-1,1876997945152,18364.12,19191.63,0.0450612389812
1358,2020-12-08,19191.53,19283.48,18269.95,18321.14,18321.14,31692288756,BTC,75.2601849497902500000,18652.047333,-0.01774107298208195,-1,1845305656396,19107.46,18321.14,-0.0411525132069
1359,2020-12-09,18320.88,18626.29,17935.55,18553.92,18553.92,34420373071,BTC,69.2986724609127500000,18615.144667,-0.00328897078670229,1,1879726029467,18732.12,18553.92,-0.0095130716651
1360,2020-12-10,18553.30,18553.30,17957.06,18264.99,18264.99,25547132265,BTC,58.5722003304945000000,18584.002667,-0.01716598263120557,-1,1854178897202,17150.62,18264.99,0.0649754935973
1361,2020-12-11,18263.93,18268.45,17619.53,18058.90,18058.90,27919640985,BTC,47.3233721558407500000,18644.554667,-0.03141156640424250,-1,1826259256217,17108.40,18058.90,0.0555575039162
1362,2020-12-12,18051.32,18919.55,18046.04,18803.66,18803.66,21752580802,BTC,49.5096153548332500000,18757.572000,0.00245703441788735,1,1848011837019,17717.41,18803.66,0.0613097512560
1363,2020-12-13,18806.77,19381.54,18734.33,19142.38,19142.38,25450468637,BTC,52.4411147624910000000,18852.570000,0.01537243993789706,1,1873462305656,18177.48,19142.38,0.0530821654047
1364,2020-12-14,19144.49,19305.10,19012.71,19246.64,19246.64,22473997681,BTC,59.9053312340842500000,18923.847333,0.01705745461374041,1,1895936303337,19625.84,19246.64,-0.0193214659857
1365,2020-12-15,19246.92,19525.01,19079.84,19417.08,19417.08,26741982541,BTC,74.9555404638592500000,18909.930000,0.02681924258841783,1,1922678285878,18803.00,19417.08,0.0326586183056
1366,2020-12-16,19418.82,21458.91,19298.32,21310.60,21310.60,44409011479,BTC,85.7259119210255000000,19077.103333,0.11707734806554450,1,1967087297357,19201.09,21310.60,0.1098640754249
1367,2020-12-17,21308.35,23642.66,21234.68,22805.16,22805.16,71378606374,BTC,93.4393534057027500000,19317.374667,0.18055172574553865,1,2038465903731,19445.40,22805.16,0.1727791662810
1368,2020-12-18,22806.80,23238.60,22399.81,23137.96,23137.96,40387896275,BTC,99.4893617021277500000,19563.545333,0.18270791955947978,1,2078853800006,18699.77,23137.96,0.2373392827826
1369,2020-12-19,23132.87,24085.86,22826.47,23869.83,23869.83,38487546580,BTC,100.0000000000000000000,19908.216000,0.19899392291102327,1,2117341346586,19154.23,23869.83,0.2461910502275
1370,2020-12-20,23861.77,24209.66,23147.71,23477.29,23477.29,37844228422,BTC,98.3111997563212500000,20196.420000,0.16244809723703508,-1,2079497118164,19345.12,23477.29,0.2136027070393
1371,2020-12-21,23474.46,24059.98,22159.37,22803.08,22803.08,45852713981,BTC,93.7217880786725000000,20426.950667,0.11632325214544466,-1,2033644404183,19191.63,22803.08,0.1881783881828
1372,2020-12-22,22794.04,23789.90,22430.61,23783.03,23783.03,44171632681,BTC,93.3483538779507500000,20733.044000,0.14710748696621683,1,2077816036864,18321.14,23783.03,0.2981195493294
1373,2020-12-23,23781.97,24024.49,22802.65,23241.35,23241.35,51146161904,BTC,90.6444837573332500000,21061.058000,0.10352243462792800,-1,2026669874960,18553.92,23241.35,0.2526382564978
1374,2020-12-24,23240.20,23768.34,22777.60,23735.95,23735.95,41080759713,BTC,91.7573004665347500000,21406.526667,0.10881836970735688,1,2067750634673,18264.99,23735.95,0.2995326030838
1375,2020-12-25,23733.57,24710.10,23463.67,24664.79,24664.79,42068395846,BTC,96.3467121441835000000,21833.180000,0.12969297188957358,1,2109819030519,18058.90,24664.79,0.3657969200782
1376,2020-12-26,24677.02,26718.07,24522.69,26437.04,26437.04,48332647295,BTC,96.7201463449052500000,22391.722667,0.18066128243727412,1,2158151677814,18803.66,26437.04,0.4059518200180
1377,2020-12-27,26439.37,28288.84,25922.77,26272.29,26272.29,66479895605,BTC,98.8593911094402500000,22889.631333,0.14778126470404171,-1,2091671782209,19142.38,26272.29,0.3724672689603
1378,2020-12-28,26280.82,27389.11,26207.64,27084.81,27084.81,49056742893,BTC,99.4353746439175000000,23419.126667,0.15652519349345898,1,2140728525102,19246.64,27084.81,0.4072487457551
1379,2020-12-29,27081.81,27370.72,25987.30,27362.44,27362.44,45265946774,BTC,99.4353746439175000000,23960.180000,0.14199642907524067,1,2185994471876,19417.08,27362.44,0.4091943793815
1380,2020-12-30,27360.09,28937.74,27360.09,28840.95,28840.95,51287442704,BTC,99.4353746439175000000,24588.438000,0.17294762684803321,1,2237281914580,21310.60,28840.95,0.3533617073194
1381,2020-12-31,28841.57,29244.88,28201.99,29001.72,29001.72,46754964848,BTC,100.0000000000000000000,25101.179333,0.15539272538768886,1,2284036879428,22805.16,29001.72,0.2717174534184
1382,2021-01-01,28994.01,29600.63,28803.59,29374.15,29374.15,40730301359,BTC,100.0000000000000000000,25539.112000,0.15016332596058939,1,2324767180787,23137.96,29374.15,0.2695220321930
1383,2021-01-02,29376.46,33155.12,29091.18,32127.27,32127.27,67865420765,BTC,100.0000000000000000000,26138.399333,0.22912155372264853,1,2392632601552,23869.83,32127.27,0.3459362718545
1384,2021-01-03,32129.41,34608.56,32052.32,32782.02,32782.02,78665235202,BTC,100.0000000000000000000,26732.545333,0.22629624645327820,1,2471297836754,23477.29,32782.02,0.3963289630106
1385,2021-01-04,32810.95,33440.22,28722.76,31971.91,31971.91,81163475344,BTC,97.9704507693202500000,27298.853333,0.17118142692649339,-1,2390134361410,22803.08,31971.91,0.4020873496037
1386,2021-01-05,31977.04,34437.59,30221.19,33992.43,33992.43,67547324782,BTC,97.9704507693202500000,28044.810000,0.21207560329344360,1,2457681686192,23783.03,33992.43,0.4292724686468
1387,2021-01-06,34013.61,36879.70,33514.04,36824.36,36824.36,75289433811,BTC,97.9704507693202500000,28914.232000,0.27357212877035779,1,2532971120003,23241.35,36824.36,0.5844329180534
1388,2021-01-07,36833.88,40180.37,36491.19,39371.04,39371.04,84762141031,BTC,97.9704507693202500000,29989.544667,0.31282553427105689,1,2617733261034,23735.95,39371.04,0.6587092574765
1389,2021-01-08,39381.77,41946.74,36838.64,40797.61,40797.61,88107519480,BTC,100.0000000000000000000,31126.988667,0.31068284299703343,1,2705840780514,24664.79,40797.61,0.6540830065855
1390,2021-01-09,40788.64,41436.35,38980.88,40254.55,40254.55,61984162837,BTC,99.0653217966970000000,32166.306000,0.25145081937602658,-1,2643856617677,26437.04,40254.55,0.5226572263763
1391,2021-01-10,40254.22,41420.19,35984.63,38356.44,38356.44,79980747690,BTC,94.8637448262757500000,32960.932667,0.16369401277294263,-1,2563875869987,26272.29,38356.44,0.4599580013771
1392,2021-01-11,38346.53,38346.53,30549.60,35566.66,35566.66,123320567399,BTC,85.3271257550430000000,33580.557333,0.05914442239016188,-1,2440555302588,27084.81,35566.66,0.3131589256118
1393,2021-01-12,35516.36,36568.53,32697.98,33922.96,33922.96,74773277909,BTC,72.5348611242270000000,34036.434000,-0.00333389802233689,-1,2365782024679,27362.44,33922.96,0.2397637052836
1394,2021-01-13,33915.12,37599.96,32584.67,37316.36,37316.36,69364315979,BTC,66.1906462252757500000,34700.028667,0.07539853520317554,1,2435146340658,28840.95,37316.36,0.2938672269811
1395,2021-01-14,37325.11,39966.41,36868.56,39187.33,39187.33,63615990033,BTC,66.9794243310077500000,35389.787333,0.10730617370675455,1,2498762330691,29001.72,39187.33,0.3512071008202
1396,2021-01-15,39156.71,39577.71,34659.59,36825.37,36825.37,67760757881,BTC,67.8228803850810000000,35911.364000,0.02545172051944337,-1,2431001572810,29374.15,36825.37,0.2536658933110
1397,2021-01-16,36821.65,37864.37,35633.55,36178.14,36178.14,57706187875,BTC,67.5298656612850000000,36364.963333,-0.00513745418328152,-1,2373295384935,32127.27,36178.14,0.1260882110431
1398,2021-01-17,36163.65,36722.35,34069.32,35791.28,35791.28,52359854336,BTC,60.6276456506982500000,36609.230667,-0.02234274395001998,-1,2320935530599,32782.02,35791.28,0.0917960516161
1399,2021-01-18,35792.24,37299.29,34883.84,36630.07,36630.07,49511702429,BTC,52.2353185763685000000,36865.767333,-0.00639339284249803,1,2370447233028,31971.91,36630.07,0.1456953932374
1400,2021-01-19,36642.23,37755.89,36069.80,36069.80,36069.80,57244195486,BTC,43.7355699543900000000,37138.960000,-0.02878809745884107,-1,2313203037542,33992.43,36069.80,0.0611127242154
1401,2021-01-20,36050.11,36378.33,33570.48,35547.75,35547.75,66834573161,BTC,37.7294773846130000000,37242.648000,-0.04550959963963894,-1,2246368464381,36824.36,35547.75,-0.0346675407258
1402,2021-01-21,35549.40,35552.68,30250.75,30825.70,30825.70,75643067688,BTC,26.9105904974540000000,36842.737333,-0.16331678286050006,-1,2170725396693,39371.04,30825.70,-0.2170463365966
1403,2021-01-22,30817.63,33811.85,28953.37,33005.76,33005.76,77207272511,BTC,19.1812190332675000000,36418.385333,-0.09370611304690926,1,2247932669204,40797.61,33005.76,-0.1909879034581
1404,2021-01-23,32985.76,33360.98,31493.16,32067.64,32067.64,48354737975,BTC,14.6670561086995000000,35836.387333,-0.10516538115240044,-1,2199577931229,40254.55,32067.64,-0.2033785000702
1405,2021-01-24,32064.38,32944.01,31106.69,32289.38,32289.38,48643830599,BTC,13.1346082754575000000,35305.376000,-0.08542597025450175,1,2248221761828,38356.44,32289.38,-0.1581757848226
1406,2021-01-25,32285.80,34802.74,32087.79,32366.39,32366.39,59897054838,BTC,17.7410366871427500000,34906.039333,-0.07275673154355922,1,2308118816666,35566.66,32366.39,-0.0899794920299
1407,2021-01-26,32358.61,32794.55,31030.27,32569.85,32569.85,60255421470,BTC,17.4902769096310000000,34706.252000,-0.06155669013179527,1,2368374238136,33922.96,32569.85,-0.0398877338534
1408,2021-01-27,32564.03,32564.03,29367.14,30432.55,30432.55,62576762015,BTC,14.1973514733370000000,34473.558000,-0.11722050854164807,-1,2305797476121,37316.36,30432.55,-0.1844716365691
1409,2021-01-28,30441.04,33858.31,30023.21,33466.10,33466.10,76517157706,BTC,18.4837247160355000000,34216.874000,-0.02194163031959027,1,2382314633827,39187.33,33466.10,-0.1459969331924
1410,2021-01-29,34318.67,38406.26,32064.81,34316.39,34316.39,117894572511,BTC,29.0655856664785000000,33892.144667,0.01251751216006929,-1,2264420061316,36825.37,34316.39,-0.0681318341133
1411,2021-01-30,34295.93,34834.71,32940.19,34269.52,34269.52,65141828798,BTC,39.3286872107475000000,33721.754667,0.01624367825485788,-1,2199278232518,36178.14,34269.52,-0.0527561671219
1412,2021-01-31,34270.88,34288.33,32270.18,33114.36,33114.36,52754542671,BTC,50.1467644416397500000,33517.502667,-0.01202782531280047,-1,2146523689847,35791.28,33114.36,-0.0747925192952
1413,2021-02-01,33114.58,34638.21,32384.23,33537.18,33537.18,61400400660,BTC,54.0078897829415000000,33367.229333,0.00509334069376626,1,2207924090507,36630.07,33537.18,-0.0844358200790
1414,2021-02-02,33533.20,35896.88,33489.22,35510.29,35510.29,63088585433,BTC,61.3382930457632500000,33292.577333,0.06661282618098109,1,2271012675940,36069.80,35510.29,-0.0155118686547
1415,2021-02-03,35510.82,37480.19,35443.98,37472.09,37472.09,61166818159,BTC,70.8604486822115000000,33386.063333,0.12238719570633602,1,2332179494099,35547.75,37472.09,0.0541339465930
1416,2021-02-04,37475.11,38592.18,36317.50,36926.07,36926.07,68838074392,BTC,83.1032532703017500000,33477.951333,0.10299670468787344,-1,2263341419707,30825.70,36926.07,0.1978988311701
1417,2021-02-05,36931.55,38225.91,36658.76,38144.31,38144.31,58598066402,BTC,95.5795744439325000000,33965.858667,0.12301915797169680,1,2321939486109,33005.76,38144.31,0.1556864619994
1418,2021-02-06,38138.39,40846.55,38138.39,39266.01,39266.01,71326033653,BTC,98.0608818189825000000,34383.208667,0.14201121775136624,1,2393265519762,32067.64,39266.01,0.2244745793579
1419,2021-02-07,39250.19,39621.84,37446.15,38903.44,38903.44,65500641143,BTC,97.0347550238195000000,34838.928667,0.11666579566351509,-1,2327764878619,32289.38,38903.44,0.2048370083291
1420,2021-02-08,38886.83,46203.93,38076.32,46196.46,46196.46,101467222687,BTC,98.9738732048370000000,35766.067333,0.29162816727620122,1,2429232101306,32366.39,46196.46,0.4272972673196
1421,2021-02-09,46184.99,48003.72,45166.96,46481.11,46481.11,91809846886,BTC,98.9738732048370000000,36707.048667,0.26627205640171714,1,2521041948192,32569.85,46481.11,0.4271207880908
1422,2021-02-10,46469.76,47145.57,43881.15,44918.18,44918.18,87301089896,BTC,96.5391843604795000000,37530.270667,0.19685201310035092,-1,2433740858296,30432.55,44918.18,0.4759913316498
1423,2021-02-11,44898.71,48463.47,44187.76,47909.33,47909.33,81388911810,BTC,97.5653111556425000000,38695.389333,0.23811469081517201,1,2515129770106,33466.10,47909.33,0.4315779251242
1424,2021-02-12,47877.04,48745.73,46424.98,47504.85,47504.85,76555041196,BTC,96.8818356230797500000,39631.306000,0.19866980916551173,-1,2438574728910,34316.39,47504.85,0.3843195627512
1425,2021-02-13,47491.20,48047.75,46392.28,47105.52,47105.52,70250456155,BTC,95.5235868398785000000,40483.914667,0.16356138944234871,-1,2368324272755,34269.52,47105.52,0.3745602506250
1426,2021-02-14,47114.51,49487.64,47114.51,48717.29,48717.29,71248675228,BTC,97.9582756842360000000,41447.099333,0.17540891362719576,1,2439572947983,33114.36,48717.29,0.4711831966555
1427,2021-02-15,48696.54,48875.57,46347.48,47945.06,47945.06,77069903166,BTC,96.6864963624787500000,42435.812667,0.12982542307441749,-1,2362503044817,33537.18,47945.06,0.4296091680934
1428,2021-02-16,47944.46,50341.10,47201.30,49199.87,49199.87,77049582886,BTC,97.3699718950415000000,43479.992000,0.13155195612731483,1,2439552627703,35510.29,49199.87,0.3855102281620
1429,2021-02-17,49207.28,52533.91,49072.38,52149.01,52149.01,80820545404,BTC,98.7282206782427500000,44589.240000,0.16954247257858622,1,2520373173107,37472.09,52149.01,0.3916760447576
1430,2021-02-18,52140.97,52474.11,51015.77,51679.80,51679.80,52054723579,BTC,97.9576566479042500000,45536.420667,0.13491133565208111,-1,2468318449528,36926.07,51679.80,0.3995477991565
1431,2021-02-19,51675.98,56113.65,50937.28,55888.13,55888.13,63495496918,BTC,99.2294359696615000000,46800.558000,0.19417657370666392,1,2531813946446,38144.31,55888.13,0.4651760642675
1432,2021-02-20,55887.34,57505.23,54626.56,56099.52,56099.52,68145460026,BTC,99.2294359696615000000,47997.572000,0.16879912175557547,1,2599959406472,39266.01,56099.52,0.4287043679763
1433,2021-02-21,56068.57,58330.57,55672.61,57539.95,57539.95,51897585191,BTC,99.2294359696615000000,49215.834667,0.16913490118214843,1,2651856991663,38903.44,57539.95,0.4790452977937
1434,2021-02-22,57532.74,57533.39,48967.57,54207.32,54207.32,92052420332,BTC,93.3990438741952500000,50236.093333,0.07905126381297067,-1,2559804571331,46196.46,54207.32,0.1734085252420
1435,2021-02-23,54204.93,54204.93,45290.59,48824.43,48824.43,106102492824,BTC,76.1361718681295000000,50411.291333,-0.03147829168901326,-1,2453702078507,46481.11,48824.43,0.0504144586909
1436,2021-02-24,48835.09,51290.14,47213.50,49705.33,49705.33,63695521388,BTC,60.6181026908270000000,50626.239333,-0.01819035632772585,1,2517397599895,44918.18,49705.33,0.1065748879407
1437,2021-02-25,49709.08,51948.97,47093.85,47093.85,47093.85,54506565949,BTC,35.6181026908270000000,50771.284000,-0.07243137676013866,-1,2462891033946,47909.33,47093.85,-0.0170213192295
1438,2021-02-26,47180.46,48370.79,44454.84,46339.76,46339.76,350967941479,BTC,17.2190588166317500000,50666.646000,-0.08539910062331736,-1,2111923092467,47504.85,46339.76,-0.0245257063226
1439,2021-02-27,46344.77,48253.27,45269.03,46188.45,46188.45,45910946382,BTC,9.4819308226975000000,50578.886000,-0.08680373071087410,-1,2066012146085,47105.52,46188.45,-0.0194684189878
1440,2021-02-28,46194.02,46716.43,43241.62,45137.77,45137.77,53443887451,BTC,0E-19,50447.702667,-0.10525618385539396,-1,2012568258634,48717.29,45137.77,-0.0734753513588
1441,2021-03-01,45159.50,49784.02,45115.09,49631.24,49631.24,53891300112,BTC,9.0578228988775000000,50508.632667,-0.01737114272691939,1,2066459558746,47945.06,49631.24,0.0351690038557
1442,2021-03-02,49612.11,50127.51,47228.84,48378.99,48378.99,47530897720,BTC,15.5913919972135000000,50537.561333,-0.04271221792394832,-1,2018928661026,49199.87,48378.99,-0.0166845969308
1443,2021-03-03,48415.82,52535.14,48274.32,50538.24,50538.24,53220811975,BTC,26.4775225000767500000,50626.786000,-0.00174899508730418,1,2072149473001,52149.01,50538.24,-0.0308878346876
1444,2021-03-04,50522.30,51735.09,47656.93,48561.17,48561.17,52343816680,BTC,33.3783254234337500000,50387.596667,-0.03624754478905657,-1,2019805656321,51679.80,48561.17,-0.0603452412742
1445,2021-03-05,48527.03,49396.43,46542.52,48927.30,48927.30,48625928883,BTC,31.9593410190790000000,50204.096667,-0.02543212111690598,1,2068431585204,55888.13,48927.30,-0.1245493452724
1446,2021-03-06,48899.23,49147.22,47257.53,48912.38,48912.38,34363564661,BTC,33.0345350575462500000,49739.046667,-0.01662007461732198,1,2102795149865,56099.52,48912.38,-0.1281141086412
1447,2021-03-07,48918.68,51384.37,48918.68,51206.69,51206.69,43137459378,BTC,34.3819796197120000000,49412.858000,0.03630293961138617,1,2145932609243,57539.95,51206.69,-0.1100671794119
1448,2021-03-08,51174.12,52314.07,49506.05,52246.52,52246.52,48597428048,BTC,47.0762778866015000000,49059.962667,0.06495229836657470,1,2194530037291,54207.32,52246.52,-0.0361722365171
1449,2021-03-09,52272.97,54824.12,51981.83,54824.12,54824.12,50912227385,BTC,64.4374393920787500000,49101.082667,0.11655623505928018,1,2245442264676,48824.43,54824.12,0.1228829501952
1450,2021-03-10,54824.01,57258.25,53290.89,56008.55,56008.55,57295577614,BTC,81.8286762552755000000,49580.024000,0.12965959838986766,1,2302737842290,49705.33,56008.55,0.1268117523815
1451,2021-03-11,55963.18,58091.06,54484.59,57805.12,57805.12,56772343595,BTC,94.5951011902465000000,50120.010000,0.15333416733157076,1,2359510185885,47093.85,57805.12,0.2274451971967
1452,2021-03-12,57821.22,57996.62,55376.65,57332.09,57332.09,55689944702,BTC,99.0664385210797500000,50802.559333,0.12852759295452640,-1,2303820241183,46339.76,57332.09,0.2372116299264
1453,2021-03-13,57343.37,61683.86,56217.97,61243.09,61243.09,60669829814,BTC,99.0664385210797500000,51796.114667,0.18238772142920586,1,2364490070997,46188.45,61243.09,0.3259394935314
1454,2021-03-14,61221.13,61597.92,59302.32,59302.32,59302.32,43901225564,BTC,96.0538159839305000000,52670.372667,0.12591419041079176,-1,2320588845433,45137.77,59302.32,0.3138070400908
1455,2021-03-15,59267.43,60540.99,55393.16,55907.20,55907.20,66419369890,BTC,85.6840854936512500000,53388.334667,0.04718006936741824,-1,2254169475543,49631.24,55907.20,0.1264518073697
1456,2021-03-16,55840.79,56833.18,53555.03,56804.90,56804.90,59749798599,BTC,77.9925002464110000000,53866.578667,0.05454813366121744,1,2313919274142,48378.99,56804.90,0.1741646528793
1457,2021-03-17,56825.83,58969.82,54528.63,58870.89,58870.89,60258313191,BTC,73.3161578629232500000,54566.038667,0.07889250233595301,1,2374177587333,50538.24,58870.89,0.1648781200137
1458,2021-03-18,58893.08,60116.25,54253.58,57858.92,57858.92,55746041000,BTC,69.6575310939737500000,55054.084000,0.05094691975984924,-1,2318431546333,48561.17,57858.92,0.1914647031775
1459,2021-03-19,57850.44,59498.38,56643.70,58346.65,58346.65,49063873786,BTC,74.1548503443487500000,55706.449333,0.04739488333240383,1,2367495420119,48927.30,58346.65,0.1925172654122
1460,2021-03-20,58332.26,60031.29,58213.30,58313.64,58313.64,50361731222,BTC,76.8406594330172500000,56332.205333,0.03517410077036794,-1,2317133688897,48912.38,58313.64,0.1922061449474
1461,2021-03-21,58309.91,58767.90,56005.62,57523.42,57523.42,51943414539,BTC,72.2515530500150000000,56906.274667,0.01084494349017514,-1,2265190274358,51206.69,57523.42,0.1233575144185
1462,2021-03-22,57517.89,58471.48,54288.16,54529.14,54529.14,56521454974,BTC,60.2658308658680000000,57127.771333,-0.04548805725069296,-1,2208668819384,52246.52,54529.14,0.0436894170176
1463,2021-03-23,54511.66,55985.44,53470.70,54738.95,54738.95,56435023914,BTC,41.9194886149062500000,57293.933333,-0.04459430840871223,1,2265103843298,54824.12,54738.95,-0.0015535133076
1464,2021-03-24,54710.49,57262.38,52514.33,52774.27,52774.27,70567223787,BTC,22.8588262523982500000,57157.276667,-0.07668326628883191,-1,2194536619511,56008.55,52774.27,-0.0577461833952
1465,2021-03-25,52726.75,53392.39,50856.57,51704.16,51704.16,67999812841,BTC,7.1242750188882500000,56870.317333,-0.09084101470280080,-1,2126536806670,57805.12,51704.16,-0.1055435919863
1466,2021-03-26,51683.01,55137.31,51579.86,55137.31,55137.31,56652197978,BTC,9.7789800075452500000,56692.463333,-0.02743139460822765,1,2183189004648,57332.09,55137.31,-0.0382818766942
1467,2021-03-27,55137.57,56568.21,54242.91,55973.51,55973.51,47266542233,BTC,20.1870125894622500000,56601.891333,-0.01110177271821377,1,2230455546881,61243.09,55973.51,-0.0860436663140
1468,2021-03-28,55974.94,56610.31,55071.11,55950.75,55950.75,47686580918,BTC,34.1594414406577500000,56249.068667,-0.00530353077961301,-1,2182768965963,59302.32,55950.75,-0.0565166759075
1469,2021-03-29,55947.90,58342.10,55139.34,57750.20,57750.20,57625587027,BTC,55.2500922674645000000,56145.594000,0.02857937525783412,1,2240394552990,55907.20,57750.20,0.0329653425677
1470,2021-03-30,57750.13,59447.22,57251.55,58917.69,58917.69,54414116432,BTC,71.2523587690532500000,56346.293333,0.04563559579337982,1,2294808669422,56804.90,58917.69,0.0371937984223
1471,2021-03-31,58930.28,59930.03,57726.42,58918.83,58918.83,65520826225,BTC,85.0630796780022500000,56487.222000,0.04304704522378530,-1,2229287843197,58870.89,58918.83,0.0008143243630
1472,2021-04-01,58926.56,59586.07,58505.28,59095.81,59095.81,61669163792,BTC,96.0906508268067500000,56502.216667,0.04590250588371664,1,2290957006989,57858.92,59095.81,0.0213776890409
1473,2021-04-02,59098.88,60267.19,58869.28,59384.31,59384.31,58727860620,BTC,100.0000000000000000000,56603.909333,0.04912029398257534,1,2349684867609,58346.65,59384.31,0.0177843972190
1474,2021-04-03,59397.41,60110.27,57603.89,57603.89,57603.89,59641344484,BTC,94.2044751730110000000,56554.392000,0.01855732088853506,-1,2290043523125,58313.64,57603.89,-0.0121712518718
1475,2021-04-04,57604.84,58913.75,57168.68,58758.55,58758.55,50749662970,BTC,92.1675357903167500000,56584.052667,0.03842950850122076,1,2340793186095,57523.42,58758.55,0.0214717761913
1476,2021-04-05,58760.88,59891.30,57694.82,59057.88,59057.88,60706272115,BTC,91.1049588875220000000,56686.350000,0.04183599755496694,1,2401499458210,54529.14,59057.88,0.0830517407757
1477,2021-04-06,59171.93,59479.58,57646.81,58192.36,58192.36,66058027988,BTC,87.2249890952652500000,56930.564667,0.02216375931594095,-1,2335441430222,54738.95,58192.36,0.0630887147086
1478,2021-04-07,58186.51,58731.14,55604.02,56048.94,56048.94,75645303584,BTC,82.1634017564762500000,57017.897333,-0.01699391556551141,-1,2259796126638,52774.27,56048.94,0.0620505030197
1479,2021-04-08,56099.91,58338.74,55879.09,58323.95,58323.95,53053855641,BTC,80.7487158453937500000,57387.876000,0.01631135468404511,1,2312849982279,51704.16,58323.95,0.1280320577687
1480,2021-04-09,58326.56,58937.05,57807.86,58245.00,58245.00,46655208546,BTC,75.1047351781390000000,57823.932000,0.00728189843610082,-1,2266194773733,55137.31,58245.00,0.0563627423971
1481,2021-04-10,58253.78,61276.66,58038.71,59793.23,59793.23,58238470525,BTC,78.9847049703957500000,58134.326667,0.02853569359291604,1,2324433244258,55973.51,59793.23,0.0682415664124
1482,2021-04-11,59846.23,60790.55,59289.80,60204.96,60204.96,46280252580,BTC,89.8418171361737500000,58416.423333,0.03061701769730976,1,2370713496838,55950.75,60204.96,0.0760349056983
1483,2021-04-12,60175.95,61253.04,59589.88,59893.45,59893.45,51828688519,BTC,91.4195943733965000000,58679.270000,0.02069180478898255,-1,2318884808319,57750.20,59893.45,0.0371124255847
1484,2021-04-13,59890.02,63742.29,59869.96,63503.46,63503.46,69983454362,BTC,98.1261519434460000000,59062.820667,0.07518501965960298,1,2388868262681,58917.69,63503.46,0.0778334995822
1485,2021-04-14,63523.75,64863.10,61554.80,63109.70,63109.70,77451779687,BTC,96.8056108489155000000,59342.288000,0.06348612645336493,-1,2311416482994,58918.83,63109.70,0.0711295523010
1486,2021-04-15,63075.20,63821.67,62208.96,63314.01,63314.01,60954381579,BTC,96.1702580696620000000,59635.300000,0.06168678618200965,1,2372370864573,59095.81,63314.01,0.0713790030122
1487,2021-04-16,63258.50,63594.72,60222.53,61572.79,61572.79,84293007468,BTC,91.5692760902110000000,59800.432000,0.02963787953906420,-1,2288077857105,59384.31,61572.79,0.0368528320023
1488,2021-04-17,61529.92,62572.18,60361.35,60683.82,60683.82,66138759198,BTC,82.1131340448480000000,59887.066000,0.01330427508337109,-1,2221939097907,57603.89,60683.82,0.0534673960387
1489,2021-04-18,60701.89,61057.46,52829.54,56216.18,56216.18,97468872758,BTC,58.9945429081952500000,59794.552000,-0.05984444870495894,-1,2124470225149,58758.55,56216.18,-0.0432680860913
1490,2021-04-19,56191.59,57520.05,54368.59,55724.27,55724.27,65344865159,BTC,34.6298956874487500000,59592.266667,-0.06490769496341299,-1,2059125359990,59057.88,55724.27,-0.0564464894439
1491,2021-04-20,55681.79,57062.15,53448.05,56473.03,56473.03,67849323955,BTC,18.5110173810685000000,59419.943333,-0.04959468433830322,1,2126974683945,58192.36,56473.03,-0.0295456310760
1492,2021-04-21,56471.13,56757.97,53695.47,53906.09,53906.09,54926612466,BTC,2.9671594264315000000,59134.192000,-0.08841081315527233,-1,2072048071479,56048.94,53906.09,-0.0382317667381
1493,2021-04-22,53857.11,55410.23,50583.81,51762.27,51762.27,74798630778,BTC,2.4062916576147500000,58848.414000,-0.12041350851018687,-1,1997249440701,58323.95,51762.27,-0.1125040399356
1494,2021-04-23,51739.81,52120.79,47714.66,51093.65,51093.65,86668667320,BTC,2.4062916576147500000,58366.394000,-0.12460499101589178,-1,1910580773381,58245.00,51093.65,-0.1227804961799
1495,2021-04-24,51143.23,51167.56,48805.29,50050.87,50050.87,49014494781,BTC,0E-19,57820.118667,-0.13436929646832750,-1,1861566278600,59793.23,50050.87,-0.1629341649548
1496,2021-04-25,50052.83,50506.02,47159.48,49004.25,49004.25,46117114240,BTC,0E-19,57100.853333,-0.14179478694972098,-1,1815449164360,60204.96,49004.25,-0.1860429771899
1497,2021-04-26,49077.79,54288.00,48852.80,54021.75,54021.75,58284039825,BTC,8.6513334174757500000,56688.639333,-0.04704451128795274,1,1873733204185,59893.45,54021.75,-0.0980357618404
1498,2021-04-27,54030.30,55416.96,53319.19,55033.12,55033.12,49448222757,BTC,19.0465032232790000000,56364.617333,-0.02362292863860966,1,1923181426942,63503.46,55033.12,-0.1333839132545
1499,2021-04-28,55036.64,56227.21,53887.92,54824.70,54824.70,48000572955,BTC,29.2151748152555000000,55786.033333,-0.01723250920640968,-1,1875180853987,63109.70,54824.70,-0.1312793437459
1500,2021-04-29,54858.09,55115.84,52418.03,53555.11,53555.11,46088929780,BTC,37.1657973274430000000,55149.060667,-0.02890258959485389,-1,1829091924207,63314.01,53555.11,-0.1541349221128
1501,2021-04-30,53568.66,57900.72,53129.60,57750.18,57750.18,52395931985,BTC,45.9109355765252500000,54778.138667,0.05425597519965473,1,1881487856192,61572.79,57750.18,-0.0620827803970
1502,2021-05-01,57714.66,58448.34,57052.27,57828.05,57828.05,42836427360,BTC,54.4030193254332500000,54528.489333,0.06051076615840052,1,1924324283552,60683.82,57828.05,-0.0470598258317
1503,2021-05-02,57825.86,57902.59,56141.91,56631.08,56631.08,38177405335,BTC,65.8430367336607500000,54258.306667,0.04373106126518919,-1,1886146878217,56216.18,56631.08,0.0073804374470
1504,2021-05-03,56620.27,58973.31,56590.87,57200.29,57200.29,51713139031,BTC,81.1138154318362500000,54323.914000,0.05294861485864218,1,1937860017248,55724.27,57200.29,0.0264879198956
1505,2021-05-04,57214.18,57214.18,53191.43,53333.54,53333.54,68564706967,BTC,75.9832892762825000000,54164.532000,-0.01534199538546738,-1,1869295310281,56473.03,53333.54,-0.0555927316101
1506,2021-05-05,53252.16,57911.36,52969.05,57424.01,57424.01,69241316747,BTC,80.9512908270812500000,54227.930667,0.05893788115623136,1,1938536627028,53906.09,57424.01,0.0652601589171
1507,2021-05-06,57441.31,58363.32,55382.51,56396.52,56396.52,69523285106,BTC,80.2867245404472500000,54393.959333,0.03681586506215363,-1,1869013341922,51762.27,56396.52,0.0895294970642
1508,2021-05-07,56413.95,58606.63,55321.85,57356.40,57356.40,68434023376,BTC,80.7290226433052500000,54766.901333,0.04728218328904593,1,1937447365298,51093.65,57356.40,0.1225739402059
1509,2021-05-08,57352.77,59464.61,56975.21,58803.78,58803.78,65382980634,BTC,93.4630771323010000000,55280.910000,0.06372670059157854,1,2002830345932,50050.87,58803.78,0.1748802768064
1510,2021-05-09,58877.39,59210.88,56482.00,58232.32,58232.32,65906690347,BTC,93.1499459857972500000,55826.340000,0.04309757723683838,-1,1936923655585,49004.25,58232.32,0.1883116260324
1511,2021-05-10,58250.87,59519.36,54071.46,55859.80,55859.80,71776546298,BTC,83.7512947689075000000,56283.376667,-0.00752578633485490,-1,1865147109287,54021.75,55859.80,0.0340242587476
1512,2021-05-11,55847.24,56872.54,54608.65,56704.57,56704.57,61308396325,BTC,75.4938207766962500000,56462.231333,0.00429204906144689,1,1926455505612,55033.12,56704.57,0.0303717107080
1513,2021-05-12,56714.53,57939.36,49150.54,49150.54,49150.54,75215403907,BTC,50.4938207766962500000,56070.059333,-0.12340845391129310,-1,1851240101705,54824.70,49150.54,-0.1034964167611
1514,2021-05-13,49735.43,51330.84,46980.02,49716.19,49716.19,96721152926,BTC,28.4166194757820000000,55729.492000,-0.10790161159193771,-1,1754518948779,53555.11,49716.19,-0.0716816751940
1515,2021-05-14,49682.98,51438.12,48868.58,49880.54,49880.54,55737497453,BTC,18.7617049320005000000,55484.520667,-0.10100079444919899,1,1810256446232,57750.18,49880.54,-0.1362703977719
1516,2021-05-15,49855.50,50639.66,46664.14,46760.19,46760.19,59161047474,BTC,3.3554796109907500000,54751.854667,-0.14596153346046797,-1,1751095398758,57828.05,46760.19,-0.1913925854322
1517,2021-05-16,46716.64,49720.04,43963.35,46456.06,46456.06,64047871555,BTC,3.3554796109907500000,53993.722000,-0.13960256342394770,-1,1687047527203,56631.08,46456.06,-0.1796720104932
1518,2021-05-17,46415.90,46623.56,42207.29,43537.51,43537.51,74903638450,BTC,1.8905569528987500000,53120.817333,-0.18040587125994024,-1,1612143888753,57200.29,43537.51,-0.2388585792135
1519,2021-05-18,43488.06,45812.46,42367.83,42909.40,42909.40,56187365084,BTC,0E-19,52168.091333,-0.17747805404456544,-1,1555956523669,53333.54,42909.40,-0.1954518676240
1520,2021-05-19,42944.98,43546.12,30681.50,37002.44,37002.44,126358098747,BTC,0E-19,51079.351333,-0.27558907788841791,-1,1429598424922,57424.01,37002.44,-0.3556277243613
1521,2021-05-20,36753.67,42462.98,35050.62,40782.74,40782.74,88281943359,BTC,4.3349399624060000000,49969.933333,-0.18385442445513138,1,1517880368281,56396.52,40782.74,-0.2768571535974
1522,2021-05-21,40596.95,42172.17,33616.45,37304.69,37304.69,82051616861,BTC,4.6815356303787500000,48697.144667,-0.23394502377713710,-1,1435828751420,57356.40,37304.69,-0.3495984754971
1523,2021-05-22,37371.03,38831.05,35383.68,37536.63,37536.63,57377273240,BTC,5.2941011882757500000,47375.826667,-0.20768390462416076,1,1493206024660,58803.78,37536.63,-0.3616629747271
1524,2021-05-23,37531.45,38289.22,31227.34,34770.58,34770.58,78469274361,BTC,5.2941011882757500000,45773.613333,-0.24037939178962479,-1,1414736750299,58232.32,34770.58,-0.4028989399701
1525,2021-05-24,34700.36,39835.14,34551.08,38705.98,38705.98,67359584098,BTC,5.4446652312970000000,44471.857333,-0.12965227176876813,1,1482096334397,55859.80,38705.98,-0.3070870285966
1526,2021-05-25,38795.78,39776.35,36581.43,38402.22,38402.22,56211915803,BTC,9.2373529312842500000,43308.018667,-0.11327691309826968,-1,1425884418594,56704.57,38402.22,-0.3227667540729
1527,2021-05-26,38392.63,40782.08,37905.84,39294.20,39294.20,51346735160,BTC,16.1092876632622500000,42147.327333,-0.06769414607141870,1,1477231153754,49150.54,39294.20,-0.2005337072594
1528,2021-05-27,39316.89,40379.62,37247.90,38436.97,38436.97,43210968721,BTC,22.1754685135092500000,41433.089333,-0.07231223597448951,-1,1434020185033,49716.19,38436.97,-0.2268721718217
1529,2021-05-28,38507.08,38856.97,34779.04,35697.61,35697.61,55200191952,BTC,19.2237706862585000000,40498.517333,-0.11854526163326988,-1,1378819993081,49880.54,35697.61,-0.2843379402067
1530,2021-05-29,35684.16,37234.50,33693.93,34616.07,34616.07,45231013335,BTC,15.0844873182985000000,39480.886000,-0.12321952450611164,-1,1333588979746,46760.19,34616.07,-0.2597106641355
1531,2021-05-30,34607.41,36400.67,33520.74,35678.13,35678.13,31646080921,BTC,9.8425142602877500000,38742.082000,-0.07908588908567175,1,1365235060667,46456.06,35678.13,-0.2320026709110
1532,2021-05-31,35658.59,37468.25,34241.95,37332.86,37332.86,39009847639,BTC,11.3894261394655000000,38133.868667,-0.02100517715615806,1,1404244908306,43537.51,37332.86,-0.1425127436089
1533,2021-06-01,37293.79,37896.73,35787.09,36684.93,36684.93,34639423297,BTC,16.0921377412400000000,37677.030000,-0.02633169334207075,-1,1369605485009,42909.40,36684.93,-0.1450607559183
1534,2021-06-02,36699.92,38231.34,35966.31,37575.18,37575.18,33070867190,BTC,28.0885231485992500000,37321.415333,0.00679943846544369,1,1402676352199,37002.44,37575.18,0.0154784387192
1535,2021-06-03,37599.41,39478.95,37243.97,39208.77,39208.77,35460750427,BTC,44.4650399064410000000,37468.504000,0.04644610310569112,1,1438137102626,40782.74,39208.77,-0.0385940228636
1536,2021-06-04,39242.48,39242.48,35717.72,36894.41,36894.41,41831090187,BTC,49.0274318257967500000,37209.282000,-0.00846218962247108,-1,1396306012439,37304.69,36894.41,-0.0109980809383
1537,2021-06-05,36880.16,37917.71,34900.41,35551.96,35551.96,35959473399,BTC,47.7923248659812500000,37092.433333,-0.04153066257935384,-1,1360346539040,37536.63,35551.96,-0.0528728870972
1538,2021-06-06,35538.61,36436.42,35304.58,35862.38,35862.38,28913440585,BTC,42.4562396212937500000,36980.816667,-0.03024369843076078,1,1389259979625,34770.58,35862.38,0.0314001089427
1539,2021-06-07,35835.27,36790.57,33480.64,33560.71,33560.71,33683936663,BTC,23.8371956315877500000,36900.158667,-0.09049957473452508,-1,1355576042962,38705.98,33560.71,-0.1329321722380
1540,2021-06-08,33589.52,34017.39,31114.44,33472.63,33472.63,49902050442,BTC,11.6617109828072500000,36551.268667,-0.08422795649168595,-1,1305673992520,38402.22,33472.63,-0.1283673183477
1541,2021-06-09,33416.98,37537.37,32475.87,37345.12,37345.12,53972919008,BTC,23.2902213007840000000,36480.795333,0.02369259384589525,1,1359646911528,39294.20,37345.12,-0.0496022313726
1542,2021-06-10,37389.52,38334.32,35847.59,36702.60,36702.60,43576032854,BTC,30.7072013300182500000,36308.022000,0.01086751572421103,-1,1316070878674,38436.97,36702.60,-0.0451224433143
1543,2021-06-11,36697.03,37608.70,36044.45,37334.40,37334.40,38699736985,BTC,47.5380754021295000000,36234.517333,0.03035455548895361,1,1354770615659,35697.61,37334.40,0.0458515289959
1544,2021-06-12,37340.14,37408.93,34728.19,35552.52,35552.52,37924228550,BTC,56.6029256324237500000,36224.844667,-0.01855976673414068,-1,1316846387109,34616.07,35552.52,0.0270524643612
1545,2021-06-13,35555.79,39322.78,34864.11,39097.86,39097.86,40669112838,BTC,64.4896219408870000000,36523.630667,0.07048120041707353,1,1357515499947,35678.13,39097.86,0.0958494741737
1546,2021-06-14,39016.97,40978.36,38757.29,40218.48,40218.48,43148914673,BTC,75.4123417489810000000,36826.320667,0.09211236071269286,1,1400664414620,37332.86,40218.48,0.0772943728394
1547,2021-06-15,40427.17,41295.27,39609.47,40406.27,40406.27,46420149185,BTC,83.5814676768697500000,37031.214667,0.09114082169191299,-1,1354244265435,36684.93,40406.27,0.1014405642862
1548,2021-06-16,40168.69,40516.78,38176.04,38347.06,38347.06,39211635100,BTC,92.0919097894142500000,37142.023333,0.03244402320778651,-1,1315032630335,37575.18,38347.06,0.0205422834967
1549,2021-06-17,38341.42,39513.67,37439.68,38053.50,38053.50,37096670047,BTC,84.0921218869165000000,37173.911333,0.02366145061036857,-1,1277935960288,39208.77,38053.50,-0.0294645815209
1550,2021-06-18,38099.48,38187.26,35255.86,35787.25,35787.25,36200887275,BTC,67.4377383308045000000,36945.810000,-0.03135835971656867,-1,1241735073013,36894.41,35787.25,-0.0300088821044
1551,2021-06-19,35854.53,36457.80,34933.06,35615.87,35615.87,31207279719,BTC,50.1654253754160000000,36860.574000,-0.03376789520423637,-1,1210527793294,35551.96,35615.87,0.0017976505374
1552,2021-06-20,35563.14,36059.48,33432.07,35698.30,35698.30,36664034054,BTC,40.6150304890360000000,36870.330000,-0.03178789015449550,1,1247191827348,35862.38,35698.30,-0.0045752680107
1553,2021-06-21,35641.14,35721.64,31295.94,31676.69,31676.69,52809038594,BTC,24.0982009449582500000,36591.284000,-0.13431050957380998,-1,1194382788754,33560.71,31676.69,-0.0561376681244
1554,2021-06-22,31622.38,33292.45,28893.62,32505.66,32505.66,58964353058,BTC,18.1266105137765000000,36520.947333,-0.10994477488188874,1,1253347141812,33472.63,32505.66,-0.0288883783557
1555,2021-06-23,32515.71,34753.41,31772.63,33723.03,33723.03,46317108925,BTC,16.2592855942615000000,36537.640667,-0.07703318045771070,1,1299664250737,37345.12,33723.03,-0.0969896468401
1556,2021-06-24,33682.80,35228.85,32385.21,34662.44,34662.44,33123368116,BTC,16.7850572421582500000,36358.795333,-0.04665598289117001,1,1332787618853,36702.60,34662.44,-0.0555862527450
1557,2021-06-25,34659.11,35487.25,31350.88,31637.78,31637.78,40230904226,BTC,16.7850572421582500000,36021.140667,-0.12168855804768344,-1,1292556714627,37334.40,31637.78,-0.1525836761807
1558,2021-06-26,31594.66,32637.59,30184.50,32186.28,32186.28,38585385521,BTC,15.9748694729807500000,35677.932667,-0.09786589093009793,1,1331142100148,35552.52,32186.28,-0.0946835836110
1559,2021-06-27,32287.52,34656.13,32071.76,34649.64,34649.64,35511640894,BTC,18.7016757200897500000,35617.740667,-0.02718029411385292,1,1366653741042,39097.86,34649.64,-0.1137714442683
1560,2021-06-28,34679.12,35219.89,33902.07,34434.34,34434.34,33892523752,BTC,18.1243292744817500000,35306.839333,-0.02471190708324059,-1,1332761217290,40218.48,34434.34,-0.1438179662682
1561,2021-06-29,34475.56,36542.11,34252.48,35867.78,35867.78,37901460044,BTC,30.1845585727987500000,35016.792667,0.02430226380504502,1,1370662677334,40406.27,35867.78,-0.1123214293227
1562,2021-06-30,35908.39,36074.76,34086.15,35040.84,35040.84,34059036099,BTC,41.3011420734810000000,34659.097333,0.01101421261299067,-1,1336603641235,38347.06,35040.84,-0.0862183437270
1563,2021-07-01,35035.98,35035.98,32883.78,33572.12,33572.12,37838957079,BTC,40.2514753378805000000,34340.768000,-0.02238295893673665,-1,1298764684156,38053.50,33572.12,-0.1177652515537
1564,2021-07-02,33549.60,33939.59,32770.68,33897.05,33897.05,38728974942,BTC,45.6308122536010000000,34063.671333,-0.00489146725762885,1,1337493659098,35787.25,33897.05,-0.0528176934523
1565,2021-07-03,33854.42,34909.26,33402.70,34668.55,34668.55,24383958643,BTC,51.4829352011470000000,33989.091333,0.01999049225362238,1,1361877617741,35615.87,34668.55,-0.0265982552160
1566,2021-07-04,34665.57,35937.57,34396.48,35287.78,35287.78,24924307911,BTC,60.3746174758485000000,33967.218667,0.03887752323633605,1,1386801925652,35698.30,35287.78,-0.0114997072690
1567,2021-07-05,35284.34,35284.34,33213.66,33746.00,33746.00,26721554282,BTC,65.2970449172577500000,33837.065333,-0.00269128933327405,-1,1360080371370,31676.69,33746.00,0.0653259541953
1568,2021-07-06,33723.51,35038.54,33599.92,34235.20,34235.20,26501259870,BTC,67.2955673758867500000,34007.632667,0.00669165464201290,1,1386581631240,32505.66,34235.20,0.0532073491201
1569,2021-07-07,34225.68,34997.66,33839.29,33855.33,33855.33,24796027477,BTC,62.4893026004730000000,34097.610667,-0.00710550276868759,-1,1361785603763,33723.03,33855.33,0.0039231350208
1570,2021-07-08,33889.61,33907.91,32133.18,32877.37,32877.37,29910396946,BTC,48.2433806146575000000,34041.233333,-0.03418981097467277,-1,1331875206817,34662.44,32877.37,-0.0514986827240
1571,2021-07-09,32861.67,34042.29,32318.88,33798.01,33798.01,27436021028,BTC,48.5507683215132500000,33983.604667,-0.00546130020104144,1,1359311227845,31637.78,33798.01,0.0682800752771
1572,2021-07-10,33811.24,34209.07,33116.01,33520.52,33520.52,22971873468,BTC,42.2600236101600000000,34109.120667,-0.01725640108833006,-1,1336339354377,32186.28,33520.52,0.0414536877204
1573,2021-07-11,33509.08,34584.70,33346.74,34240.19,34240.19,20108729370,BTC,40.5471899075887500000,34246.048000,-0.00017105623399231,1,1356448083747,34649.64,34240.19,-0.0118168615893
1574,2021-07-12,34254.02,34592.16,32697.31,33155.85,33155.85,24321499537,BTC,35.5491167291305000000,34146.462000,-0.02901067759230810,-1,1332126584210,34434.34,33155.85,-0.0371283433921
1575,2021-07-13,33125.47,33327.10,32261.42,32702.03,32702.03,19120856669,BTC,22.7817999442605000000,34030.974667,-0.03905103159706689,-1,1313005727541,35867.78,32702.03,-0.0882616654836
1576,2021-07-14,32723.85,33061.40,31639.13,32822.35,32822.35,21376531210,BTC,14.8846614719802500000,33827.946000,-0.02972678270208898,1,1334382258751,35040.84,32822.35,-0.0633115530335
1577,2021-07-15,32827.88,33159.64,31175.71,31780.73,31780.73,21300524237,BTC,3.4914077041022500000,33610.605333,-0.05444339115199952,-1,1313081734514,33572.12,31780.73,-0.0533594542138
1578,2021-07-16,31841.55,32218.41,31100.67,31421.54,31421.54,23699476918,BTC,1.1632988494635000000,33467.233333,-0.06112525982190665,-1,1289382257596,33897.05,31421.54,-0.0730302489450
1579,2021-07-17,31397.31,31935.95,31223.99,31533.07,31533.07,18895018942,BTC,1.8844775657357500000,33309.634667,-0.05333485896079342,1,1308277276538,34668.55,31533.07,-0.0904416250463
1580,2021-07-18,31533.88,32399.00,31215.49,31796.81,31796.81,18787986667,BTC,3.1477611322630000000,33118.185333,-0.03989878429973457,1,1327065263205,35287.78,31796.81,-0.0989285809422
1581,2021-07-19,31800.01,31885.86,30563.73,30817.83,30817.83,20434789545,BTC,3.1477611322630000000,32820.188667,-0.06100996820330070,-1,1306630473660,33746.00,30817.83,-0.0867708765483
1582,2021-07-20,30838.29,31006.19,29360.96,29807.35,29807.35,23148267245,BTC,3.1477611322630000000,32557.612000,-0.08447370157246176,-1,1283482206415,34235.20,29807.35,-0.1293361803057
1583,2021-07-21,29796.29,32752.33,29526.18,32110.69,32110.69,28203024559,BTC,15.4167873410500000000,32415.978000,-0.00941782475296596,1,1311685230974,33855.33,32110.69,-0.0515322107331
1584,2021-07-22,32138.87,32576.40,31745.30,32313.11,32313.11,19555230518,BTC,27.1220030499632500000,32313.163333,-0.00000165050383494,1,1331240461492,32877.37,32313.11,-0.0171625650105
1585,2021-07-23,32305.96,33581.55,32057.89,33581.55,33581.55,22552046192,BTC,48.4074543633425000000,32360.108667,0.03774527908942389,1,1353792507684,33798.01,33581.55,-0.0064045190826
1586,2021-07-24,33593.73,34490.39,33424.86,34292.45,34292.45,21664706865,BTC,73.4074543633425000000,32393.071333,0.05863533739898982,1,1375457214549,33520.52,34292.45,0.0230285807022
1587,2021-07-25,34290.29,35364.93,33881.84,35350.19,35350.19,20856685287,BTC,85.4172494382832500000,32515.049333,0.08719472137237615,1,1396313899836,34240.19,35350.19,0.0324180444092
1588,2021-07-26,35384.03,40499.68,35287.31,37337.54,37337.54,51022126212,BTC,96.2854513133792500000,32721.539333,0.14106917831780356,1,1447336026048,33155.85,37337.54,0.1261222378555
1589,2021-07-27,37276.04,39406.94,36441.73,39406.94,39406.94,35097370560,BTC,100.0000000000000000000,33138.278667,0.18916677586040411,1,1482433396608,32702.03,39406.94,0.2050303910797
1590,2021-07-28,39503.19,40816.07,38862.44,39995.91,39995.91,38702404695,BTC,100.0000000000000000000,33624.537333,0.18948580924404180,1,1521135801303,32822.35,39995.91,0.2185571721708
1591,2021-07-29,39995.45,40593.07,39352.06,40008.42,40008.42,27167146027,BTC,100.0000000000000000000,34103.608667,0.17314329960376683,1,1548302947330,31780.73,40008.42,0.2588892703220
1592,2021-07-30,40027.48,42235.55,38397.36,42235.55,42235.55,33072782960,BTC,100.0000000000000000000,34800.596667,0.21364442121908404,1,1581375730290,31421.54,42235.55,0.3441591341481
1593,2021-07-31,42196.30,42231.45,41110.83,41626.20,41626.20,25802845343,BTC,98.7742593456815000000,35480.907333,0.17319998638491413,-1,1555572884947,31533.07,41626.20,0.3200807913724
1594,2021-08-01,41460.84,42541.68,39540.94,39974.89,39974.89,26688438115,BTC,94.2268188474597500000,36043.695333,0.10906747021026930,-1,1528884446832,31796.81,39974.89,0.2571981277367
1595,2021-08-02,39907.26,40419.18,38746.35,39201.95,39201.95,25595265436,BTC,88.1245675158107500000,36537.371333,0.07292748683847962,-1,1503289181396,30817.83,39201.95,0.2720541971969
1596,2021-08-03,39178.40,39750.03,37782.05,38152.98,38152.98,26189830450,BTC,79.9122559984550000000,37026.381333,0.03042691795527725,-1,1477099350946,29807.35,38152.98,0.2799856411254
1597,2021-08-04,38213.33,39952.30,37589.16,39747.50,39747.50,25372562724,BTC,74.9945783734097500000,37689.058000,0.05461643535903710,1,1502471913670,32110.69,39747.50,0.2378276517882
1598,2021-08-05,39744.52,41341.93,37458.00,40869.55,40869.55,35185031017,BTC,76.1003250946975000000,38272.982000,0.06784336794033974,1,1537656944687,32313.11,40869.55,0.2647977864093
1599,2021-08-06,40865.87,43271.66,39932.18,42816.50,42816.50,38226483046,BTC,82.2025764263465000000,38973.208000,0.09861369379703103,1,1575883427733,33581.55,42816.50,0.2750007072336
1600,2021-08-07,42832.80,44689.86,42618.57,44555.80,44555.80,40030862141,BTC,90.4148879437022500000,39704.824667,0.12217596661576010,1,1615914289874,34292.45,44555.80,0.2992889105328
1601,2021-08-08,44574.44,45282.35,43331.91,43798.12,43798.12,36302664750,BTC,94.5006479038455000000,40338.536000,0.08576374710277041,-1,1579611625124,35350.19,43798.12,0.2389783477826
1602,2021-08-09,43791.93,46456.83,42848.69,46365.40,46365.40,38734079049,BTC,97.9423416807795000000,41072.883333,0.12885671122941906,1,1618345704173,37337.54,46365.40,0.2417904339707
1603,2021-08-10,46280.85,46637.99,44705.55,45585.03,45585.03,33546019517,BTC,95.5667629841225000000,41622.716000,0.09519595021141821,-1,1584799684656,39406.94,45585.03,0.1567766997387
1604,2021-08-11,45599.70,46735.63,45351.71,45593.64,45593.64,34319709073,BTC,93.2173945884487500000,42035.162667,0.08465477726802298,-1,1550479975583,39995.91,45593.64,0.1399575606606
1605,2021-08-12,45576.88,46228.91,43861.45,44428.29,44428.29,33723620826,BTC,89.3781613702175000000,42330.654667,0.04955357646843265,-1,1516756354757,40008.42,44428.29,0.1104734953292
1606,2021-08-13,44439.69,47831.98,44282.42,47793.32,47793.32,31744259539,BTC,89.3781613702175000000,42849.648000,0.11537252301349127,1,1548500614296,42235.55,47793.32,0.1315898573595
1607,2021-08-14,47810.69,48098.68,46177.63,47096.95,47096.95,31211354442,BTC,89.9478649628845000000,43173.741333,0.09087024996838256,-1,1517289259854,41626.20,47096.95,0.1314256405821
1608,2021-08-15,47096.67,47357.11,45579.59,47047.00,47047.00,30988958446,BTC,90.3618244414452500000,43535.128000,0.08066754736542867,-1,1486300301408,39974.89,47047.00,0.1769138076427
1609,2021-08-16,47019.96,47998.10,45700.32,46004.48,46004.48,32776876610,BTC,91.6197717092965000000,43937.100667,0.04705315784645650,-1,1453523424798,39201.95,46004.48,0.1735252965733
1610,2021-08-17,45936.46,47139.57,44512.42,44695.36,44695.36,33451362600,BTC,83.5859264299807500000,44303.328000,0.00884881605282565,-1,1420072062198,38152.98,44695.36,0.1714775621721
1611,2021-08-18,44686.75,45952.06,44364.03,44801.19,44801.19,32194123075,BTC,76.0946447494540000000,44746.542000,0.00122127873032066,1,1452266185273,39747.50,44801.19,0.1271448518775
1612,2021-08-19,44741.88,46970.76,43998.32,46717.58,46717.58,37204312299,BTC,74.1458258542625000000,45211.214000,0.03331841520557267,1,1489470497572,40869.55,46717.58,0.1430901490229
1613,2021-08-20,46723.12,49342.15,46650.71,49339.18,49339.18,34706867452,BTC,78.7847701238630000000,45775.856000,0.07784286983076843,1,1524177365024,42816.50,49339.18,0.1523403360854
1614,2021-08-21,49327.07,49717.02,48312.20,48905.49,48905.49,40585205312,BTC,84.8619049542755000000,46181.788667,0.05897782246243459,-1,1483592159712,44555.80,48905.49,0.0976234294974
1615,2021-08-22,48869.11,49471.61,48199.94,49321.65,49321.65,25370975378,BTC,94.0799703736022500000,46499.512000,0.06069177672230195,1,1508963135090,43798.12,49321.65,0.1261134039543
1616,2021-08-23,49291.68,50482.08,49074.61,49546.15,49546.15,34305053719,BTC,97.9641981859067500000,46882.714000,0.05681061894155701,1,1543268188809,46365.40,49546.15,0.0686018022060
1617,2021-08-24,49562.35,49878.77,47687.12,47706.12,47706.12,35361168834,BTC,88.9759198820845000000,46972.095333,0.01562682400681229,-1,1507907019975,45585.03,47706.12,0.0465304070218
1618,2021-08-25,47727.26,49202.88,47163.61,48960.79,48960.79,32646349931,BTC,88.0732320668695000000,47197.146000,0.03736759845605919,1,1540553369906,45593.64,48960.79,0.0738513090861
1619,2021-08-26,49002.64,49347.58,46405.78,46942.22,46942.22,32666549568,BTC,75.4325049923210000000,47287.051333,-0.00729229933521683,-1,1507886820338,44428.29,46942.22,0.0565839918664
1620,2021-08-27,46894.55,49112.79,46394.28,49058.67,49058.67,34511076995,BTC,72.9201307192645000000,47595.743333,0.03073650214399941,1,1542397897333,47793.32,49058.67,0.0264754572396
1621,2021-08-28,49072.59,49283.50,48499.24,48902.40,48902.40,28568103401,BTC,78.5906504724177500000,47669.682000,0.02585958093867712,-1,1513829793932,47096.95,48902.40,0.0383347541614
1622,2021-08-29,48911.25,49644.11,47925.86,48829.83,48829.83,25889650240,BTC,77.7582789423375000000,47785.207333,0.02186079595135697,-1,1487940143692,47047.00,48829.83,0.0378946585330
1623,2021-08-30,48834.85,48925.61,46950.27,47054.98,47054.98,31847007016,BTC,77.6391062074425000000,47785.739333,-0.01529241449855209,-1,1456093136676,46004.48,47054.98,0.0228347326173
1624,2021-08-31,47024.34,48189.55,46750.09,47166.69,47166.69,34730363427,BTC,67.8882202692757500000,47863.220000,-0.01455251025735419,1,1490823500103,44695.36,47166.69,0.0552927641706
1625,2021-09-01,47099.77,49111.09,46562.44,48847.03,48847.03,39139399125,BTC,67.5224914986607500000,48139.998000,0.01468699687108421,1,1529962899228,44801.19,48847.03,0.0903065298042
1626,2021-09-02,48807.85,50343.42,48652.32,49327.72,49327.72,39508070319,BTC,69.2836921360062500000,48441.766667,0.01828903844672408,1,1569470969547,46717.58,49327.72,0.0558706165859
1627,2021-09-03,49288.25,50982.27,48386.09,50025.38,50025.38,43206179619,BTC,82.1226833106397500000,48662.286667,0.02801128813217839,1,1612677149166,49339.18,50025.38,0.0139078111959
1628,2021-09-04,50009.32,50545.58,49548.78,49944.63,49944.63,37471327794,BTC,93.7311769836360000000,48702.650000,0.02550128175776883,-1,1575205821372,48905.49,49944.63,0.0212479212457
1629,2021-09-05,49937.86,51868.68,49538.60,51753.41,51753.41,30322676319,BTC,97.4146643049200000000,48892.511333,0.05851404620054844,1,1605528497691,49321.65,51753.41,0.0493041088447
1630,2021-09-06,51769.00,52700.94,51053.68,52633.54,52633.54,38884105426,BTC,99.3452334617730000000,49113.304000,0.07167581313609038,1,1644412603117,49546.15,52633.54,0.0623134189034
1631,2021-09-07,52660.48,52853.77,43285.21,46811.13,46811.13,65210059683,BTC,74.3452334617730000000,48930.969333,-0.04332306026012730,-1,1579202543434,47706.12,46811.13,-0.0187604860760
1632,2021-09-08,46827.76,47334.05,44561.39,46091.39,46091.39,49007762488,BTC,50.0000000000000000000,48823.320667,-0.05595544566976842,-1,1530194780946,48960.79,46091.39,-0.0586060804983
1633,2021-09-09,45774.74,47261.95,45669.74,46391.42,46391.42,38672657013,BTC,26.1465267534372500000,48652.029333,-0.04646485180560927,1,1568867437959,46942.22,46391.42,-0.0117335737424
1634,2021-09-10,46396.66,47031.74,44344.48,44883.91,44883.91,39154666597,BTC,1.1465267534372500000,48514.808667,-0.07484103857694392,-1,1529712771362,49058.67,44883.91,-0.0850972926906
1635,2021-09-11,44869.84,45969.29,44818.27,45201.46,45201.46,34499835245,BTC,2.1709304991645000000,48257.661333,-0.06333090432855436,1,1564212606607,48902.40,45201.46,-0.0756801302186
1636,2021-09-12,45206.63,46364.88,44790.46,46063.27,46063.27,27881980161,BTC,5.9754992334137500000,48068.386000,-0.04171381997306920,1,1592094586768,48829.83,46063.27,-0.0566571704223
1637,2021-09-13,46057.21,46598.68,43591.32,44963.07,44963.07,40969943253,BTC,5.0843395104025000000,47810.602000,-0.05955858911795338,-1,1551124643515,47054.98,44963.07,-0.0444567185025
1638,2021-09-14,44960.05,47218.13,44752.33,47092.49,47092.49,38652152880,BTC,12.2091312746545000000,47813.102667,-0.01507144750715702,1,1589776796395,47166.69,47092.49,-0.0015731440981
1639,2021-09-15,47098.00,48450.47,46773.33,48176.35,48176.35,30484496466,BTC,21.8060088030010000000,47880.413333,0.00618074587079714,1,1620261292861,48847.03,48176.35,-0.0137302104140
1640,2021-09-16,48158.91,48486.83,47079.56,47783.36,47783.36,31764293754,BTC,27.3549511396027500000,47809.502000,-0.00054679507015154,-1,1588496999107,49327.72,47783.36,-0.0313081569552
1641,2021-09-17,47771.00,48160.92,46832.52,47267.52,47267.52,28727713711,BTC,34.7890157336542500000,47672.155333,-0.00848787578773264,-1,1559769285396,50025.38,47267.52,-0.0551292164098
1642,2021-09-18,47273.53,48791.78,47087.29,48278.36,48278.36,28575630451,BTC,38.6145854705320000000,47555.687333,0.01519634574808302,1,1588344915847,49944.63,48278.36,-0.0333623454614
1643,2021-09-19,48268.86,48328.37,46919.80,47260.22,47260.22,26967722648,BTC,35.6591863095397500000,47376.726667,-0.00245915400232055,-1,1561377193199,51753.41,47260.22,-0.0868192066958
1644,2021-09-20,47261.41,47328.20,42598.91,42843.80,42843.80,43909845642,BTC,26.3056752386887500000,46782.752667,-0.08419668451400233,-1,1517467347557,52633.54,42843.80,-0.1859981297097
1645,2021-09-21,43012.23,43607.61,39787.61,40693.68,40693.68,48701090088,BTC,18.6162436142112500000,45986.762000,-0.11510012381389235,-1,1468766257469,46811.13,40693.68,-0.1306836643337
1646,2021-09-22,40677.95,43978.62,40625.63,43574.51,43574.51,38139709246,BTC,17.1614376276187500000,45770.987333,-0.04798841932379252,1,1506905966715,46091.39,43574.51,-0.0546062941473
1647,2021-09-23,43560.30,44942.18,43109.34,44895.10,44895.10,34244064430,BTC,23.3439314512940000000,45691.234667,-0.01742423186421355,1,1541150031145,46391.42,44895.10,-0.0322542401160
1648,2021-09-24,44894.30,45080.49,40936.56,42839.75,42839.75,42839345714,BTC,30.4176313305242500000,45454.456667,-0.05752365903645881,-1,1498310685431,44883.91,42839.75,-0.0455432692918
1649,2021-09-25,42840.89,42996.26,41759.92,42716.59,42716.59,31604717236,BTC,37.0853813212950000000,45309.968667,-0.05723638182272239,-1,1466705968195,45201.46,42716.59,-0.0549732243162
1650,2021-09-26,42721.63,43919.30,40848.46,43208.54,43208.54,30661222077,BTC,35.8791010299707500000,45177.107333,-0.04357444398752028,1,1497367190272,46063.27,43208.54,-0.0619741064844
1651,2021-09-27,43234.18,44313.25,42190.63,42235.73,42235.73,30980029059,BTC,27.1135037997645000000,44921.938000,-0.05979724205131132,-1,1466387161213,44963.07,42235.73,-0.0606573350085
1652,2021-09-28,42200.90,42775.14,40931.66,41034.54,41034.54,30214940550,BTC,21.1633186897795000000,44660.036000,-0.08117987186575488,-1,1436172220663,47092.49,41034.54,-0.1286394072601
1653,2021-09-29,41064.98,42545.26,40829.67,41564.36,41564.36,30602359905,BTC,17.3654326879970000000,44291.494000,-0.06157240936600603,1,1466774580568,48176.35,41564.36,-0.1372455572080
1654,2021-09-30,41551.27,44092.60,41444.58,43790.89,43790.89,31141681925,BTC,19.2849269843945000000,43999.130000,-0.00473282085350324,1,1497916262493,47783.36,43790.89,-0.0835535634162
1655,2021-10-01,43816.74,48436.01,43320.02,48116.94,48116.94,42850641582,BTC,38.6700889160780000000,44021.368667,0.09303598359199103,1,1540766904075,47267.52,48116.94,0.0179704795174
1656,2021-10-02,48137.47,48282.06,47465.50,47711.49,47711.49,30614346492,BTC,60.6781037565197500000,44050.966667,0.08309745755800215,-1,1510152557583,48278.36,47711.49,-0.0117416995938
1657,2021-10-03,47680.03,49130.69,47157.29,48199.95,48199.95,26638115879,BTC,82.8082397675315000000,44045.739333,0.09431583462801764,1,1536790673462,47260.22,48199.95,0.0198841647373
1658,2021-10-04,48208.91,49456.78,47045.00,49112.90,49112.90,33383173002,BTC,97.5994702479210000000,44169.251333,0.11192511799054360,1,1570173846464,42843.80,49112.90,0.1463245557117
1659,2021-10-05,49174.96,51839.98,49072.84,51514.81,51514.81,35873904236,BTC,98.1315296096870000000,44747.318667,0.15123791848540081,1,1606047750700,40693.68,51514.81,0.2659167222035
1660,2021-10-06,51486.66,55568.46,50488.19,55361.45,55361.45,49034730168,BTC,100.0000000000000000000,45725.170000,0.21074344830210582,1,1655082480868,43574.51,55361.45,0.2705008042546
1661,2021-10-07,55338.63,55338.63,53525.47,53805.98,53805.98,36807860413,BTC,97.2857545695477500000,46407.268000,0.15943002721039299,-1,1618274620455,44895.10,53805.98,0.1984822397099
1662,2021-10-08,53802.14,55922.98,53688.05,53967.85,53967.85,34800873924,BTC,94.8539671150302500000,47012.118000,0.14795615036957067,1,1653075494379,42839.75,53967.85,0.2597610863742
1663,2021-10-09,53929.78,55397.95,53735.14,54968.22,54968.22,32491211414,BTC,94.1677933343615000000,47820.682667,0.14946539727949886,1,1685566705793,42716.59,54968.22,0.2868119856946
1664,2021-10-10,54952.82,56401.30,54264.26,54771.58,54771.58,39527792364,BTC,93.1384890391575000000,48624.348667,0.12642290337087756,-1,1646038913429,43208.54,54771.58,0.2676100604186
1665,2021-10-11,54734.13,57793.04,54519.77,57484.79,57484.79,42637331698,BTC,95.8527344696097500000,49576.098667,0.15952629484062988,1,1688676245127,42235.73,57484.79,0.3610464410110
1666,2021-10-12,57526.83,57627.88,54477.97,56041.06,56041.06,41083758949,BTC,96.0904367278537500000,50496.454000,0.10980188826724348,-1,1647592486178,41034.54,56041.06,0.3657045991011
1667,2021-10-13,56038.26,57688.66,54370.97,57401.10,57401.10,41684252783,BTC,96.6451913194680000000,51587.558000,0.11269271555749935,1,1689276738961,41564.36,57401.10,0.3810172946245
1668,2021-10-14,57372.83,58478.73,56957.07,57321.52,57321.52,36615791366,BTC,97.3764249408682500000,52638.035333,0.08897529395562025,-1,1652660947595,43790.89,57321.52,0.3089827587427
1669,2021-10-15,57345.90,62757.13,56868.14,61593.95,61593.95,51780081801,BTC,97.3764249408682500000,53824.906000,0.14433920237594098,1,1704441029396,48116.94,61593.95,0.2800886756307
1670,2021-10-16,61609.53,62274.48,60206.12,60892.18,60892.18,34250964237,BTC,98.3067391628332500000,54676.588667,0.11367920868024844,-1,1670190065159,47711.49,60892.18,0.2762581927330
1671,2021-10-17,60887.65,61645.52,59164.47,61553.62,61553.62,29032367511,BTC,98.3628821087937500000,55599.397333,0.10709149653796662,1,1699222432670,48199.95,61553.62,0.2770473828292
1672,2021-10-18,61548.80,62614.66,60012.76,62026.08,62026.08,38055562075,BTC,98.6609527825975000000,56521.139333,0.09739613765687005,1,1737277994745,49112.90,62026.08,0.2629284770396
1673,2021-10-19,62043.16,64434.54,61622.93,64261.99,64261.99,40471196346,BTC,98.6609527825975000000,57531.078667,0.11699609131196198,1,1777749191091,51514.81,64261.99,0.2474468992509
1674,2021-10-20,64284.59,66930.39,63610.68,65992.84,65992.84,40788955582,BTC,99.9247237569060000000,58496.280667,0.12815446123276513,1,1818538146673,55361.45,65992.84,0.1920359744913
1675,2021-10-21,66002.23,66600.55,62117.41,62210.17,62210.17,45908121370,BTC,92.2402694377387500000,58952.862000,0.05525275431072371,-1,1772630025303,53805.98,62210.17,0.1561943486579
1676,2021-10-22,62237.89,63715.02,60122.80,60692.27,60692.27,38434082775,BTC,81.2203642236802500000,59411.948000,0.02154990777275978,-1,1734195942528,53967.85,60692.27,0.1246004797301
1677,2021-10-23,60694.63,61743.88,59826.52,61393.62,61393.62,26882546034,BTC,70.9736985194722500000,59906.999333,0.02481547537937006,1,1761078488562,54968.22,61393.62,0.1168929974447
1678,2021-10-24,61368.34,61505.80,59643.34,60930.84,60930.84,27316183882,BTC,59.6959988672050000000,60304.507333,0.01038616671787743,-1,1733762304680,54771.58,60930.84,0.1124535753761
1679,2021-10-25,60893.93,63729.32,60691.80,63039.82,63039.82,31064911614,BTC,60.0374082849072500000,60855.723333,0.03588974951540241,1,1764827216294,57484.79,63039.82,0.0966347793912
1680,2021-10-26,63032.76,63229.03,59991.16,60363.79,60363.79,34878965587,BTC,56.9165015035237500000,61047.656667,-0.01120217718970484,-1,1729948250707,56041.06,60363.79,0.0771350506218
1681,2021-10-27,60352.00,61435.18,58208.19,58482.39,58482.39,43657076893,BTC,45.5100336594370000000,61210.412000,-0.04456794050005741,-1,1686291173814,57401.10,58482.39,0.0188374438817
1682,2021-10-28,58470.73,62128.63,58206.92,60622.14,60622.14,45257083247,BTC,41.3036432308400000000,61425.148000,-0.01307295181445879,1,1731548257061,57321.52,60622.14,0.0575808178150
1683,2021-10-29,60624.87,62927.61,60329.96,62227.96,62227.96,36856881767,BTC,36.1898258217837500000,61752.244000,0.00770362288372873,1,1768405138828,61593.95,62227.96,0.0102933810869
1684,2021-10-30,62239.36,62330.14,60918.39,61888.83,61888.83,32157938616,BTC,36.6696388091770000000,61771.902667,0.00189288864275935,-1,1736247200212,60892.18,61888.83,0.0163674547372
1685,2021-10-31,61850.49,62406.17,60074.33,61318.96,61318.96,32241199927,BTC,42.7648497296665000000,61800.354667,-0.00778951301483475,-1,1704006000285,61553.62,61318.96,-0.0038122859387
1686,2021-11-01,61320.45,62419.00,59695.18,61004.41,61004.41,36150572843,BTC,41.6439760600230000000,61763.740667,-0.01229411720857292,-1,1667855427442,62026.08,61004.41,-0.0164716196800
1687,2021-11-02,60963.25,64242.79,60673.05,63226.40,63226.40,37746665647,BTC,44.9674786464192500000,61843.762000,0.02235695170031862,1,1705602093089,64261.99,63226.40,-0.0161151249751
1688,2021-11-03,63254.34,63516.94,61184.24,62970.05,62970.05,36124731509,BTC,48.5665306339832500000,61757.632667,0.01963186217867855,-1,1669477361580,65992.84,62970.05,-0.0458048176135
1689,2021-11-04,62941.80,63123.29,60799.66,61452.23,61452.23,32615846901,BTC,54.7749261739450000000,61454.925333,-0.00004385869782438,-1,1636861514679,62210.17,61452.23,-0.0121835384793
1690,2021-11-05,61460.08,62541.47,60844.61,61125.68,61125.68,30605102446,BTC,60.3095085382415000000,61382.626000,-0.00418597275391900,-1,1606256412233,60692.27,61125.68,0.0071411070965
1691,2021-11-06,61068.88,61590.68,60163.78,61527.48,61527.48,29094934221,BTC,60.5651701230287500000,61438.306667,0.00145142888594449,1,1635351346454,61393.62,61527.48,0.0021803568514
1692,2021-11-07,61554.92,63326.99,61432.49,63326.99,63326.99,24726754302,BTC,70.6271171435135000000,61567.198000,0.02858327254067986,1,1660078100756,60930.84,63326.99,0.0393257338976
1693,2021-11-08,63344.07,67673.74,63344.07,67566.83,67566.83,41125608330,BTC,79.9766442313570000000,62009.597333,0.08961891232992374,1,1701203709086,63039.82,67566.83,0.0718119118995
1694,2021-11-09,67549.73,68530.34,66382.06,66971.83,66971.83,42357991721,BTC,89.4096104329227500000,62271.731333,0.07547724411043075,-1,1658845717365,60363.79,66971.83,0.1094702635471
1695,2021-11-10,66953.34,68789.63,63208.11,64995.23,64995.23,48730828378,BTC,91.2856488677342500000,62580.494000,0.03858608083215195,-1,1610114888987,58482.39,64995.23,0.1113641217467
1696,2021-11-11,64978.89,65579.02,64180.49,64949.96,64949.96,35880633236,BTC,81.8652499730392500000,63011.665333,0.03076088620665118,-1,1574234255751,60622.14,64949.96,0.0713900894954
1697,2021-11-12,64863.98,65460.82,62333.91,64155.94,64155.94,36084893887,BTC,68.8712249030192500000,63247.252000,0.01436723290365248,-1,1538149361864,62227.96,64155.94,0.0309825358247
1698,2021-11-13,64158.12,64915.68,63303.73,64469.53,64469.53,30474228777,BTC,58.7092581523420000000,63396.690000,0.01692265006264523,1,1568623590641,61888.83,64469.53,0.0416989624784
1699,2021-11-14,64455.37,65495.18,63647.81,65466.84,65466.84,25122092191,BTC,57.7861346706662500000,63635.224000,0.02878305260621067,1,1593745682832,61318.96,65466.84,0.0676443305627
1700,2021-11-15,65521.29,66281.57,63548.14,63557.87,63557.87,30558763548,BTC,51.9341188159242500000,63784.484667,-0.00355281802750447,-1,1563186919284,61004.41,63557.87,0.0418569739466
1701,2021-11-16,63721.20,63721.20,59016.34,60161.25,60161.25,46844335592,BTC,39.9281438859442500000,63728.274000,-0.05597239303860638,-1,1516342583692,63226.40,60161.25,-0.0484789581567
1702,2021-11-17,60139.62,60823.61,58515.41,60368.01,60368.01,39178392930,BTC,27.4255130147075000000,63537.714667,-0.04988697946742914,1,1555520976622,62970.05,60368.01,-0.0413218665064
1703,2021-11-18,60360.14,60948.50,56550.79,56942.14,56942.14,41388338699,BTC,10.4255724440035000000,63135.854000,-0.09810137358718550,-1,1514132637923,61452.23,56942.14,-0.0733918036823
1704,2021-11-19,56896.13,58351.11,55705.18,58119.58,58119.58,38702407772,BTC,3.4685150864895000000,62913.677333,-0.07620119402057843,1,1552835045695,61125.68,58119.58,-0.0491790029984
1705,2021-11-20,58115.08,59859.88,57469.73,59697.20,59697.20,30624264863,BTC,9.9511983459540000000,62818.445333,-0.04968676503301391,1,1583459310558,61527.48,59697.20,-0.0297473584161
1706,2021-11-21,59730.51,60004.43,58618.93,58730.48,58730.48,26123447605,BTC,13.4611927500942500000,62631.978667,-0.06229243830445437,-1,1557335862953,63326.99,58730.48,-0.0725837435192
1707,2021-11-22,58706.85,59266.36,55679.84,56289.29,56289.29,35036121783,BTC,13.4611927500942500000,62162.798667,-0.09448591107462533,-1,1522299741170,67566.83,56289.29,-0.1669094139832
1708,2021-11-23,56304.55,57875.52,55632.76,57569.07,57569.07,37485803899,BTC,13.6856922568957500000,61496.281333,-0.06386095627041742,1,1559785545069,66971.83,57569.07,-0.1403987318250
1709,2021-11-24,57565.85,57803.07,55964.22,56280.43,56280.43,36635566789,BTC,7.2030089974312500000,60783.521333,-0.07408408124843576,-1,1523149978280,64995.23,56280.43,-0.1340836858336
1710,2021-11-25,57165.42,59367.97,57146.68,57274.68,57274.68,34284016248,BTC,5.7007905869932500000,60268.818000,-0.04967971995070486,1,1557433994528,64949.96,57274.68,-0.1181722051869
1711,2021-11-26,58960.29,59183.48,53569.77,53569.77,53569.77,41810748221,BTC,5.7007905869932500000,59510.138667,-0.09982111956149914,-1,1515623246307,64155.94,53569.77,-0.1650068567306
1712,2021-11-27,53736.43,55329.26,53668.36,54815.08,54815.08,30560857714,BTC,5.3226049809625000000,58887.414667,-0.06915458404870508,1,1546184104021,64469.53,54815.08,-0.1497521387235
1713,2021-11-28,54813.02,57393.84,53576.73,57248.46,57248.46,28116886357,BTC,13.0528486459992500000,58406.010000,-0.01981902204927198,1,1574300990378,65466.84,57248.46,-0.1255350036751
1714,2021-11-29,57291.91,58872.88,56792.53,57806.57,57806.57,32370840356,BTC,20.9517049560582500000,57895.325333,-0.00153303107788929,1,1606671830734,63557.87,57806.57,-0.0904891872556
1715,2021-11-30,57830.11,59113.40,56057.28,57005.43,57005.43,36708594618,BTC,33.5860779702502500000,57458.496000,-0.00788510022956396,-1,1569963236116,60161.25,57005.43,-0.0524560244343
1716,2021-12-01,56907.96,59041.68,56553.08,57229.83,57229.83,36858195307,BTC,44.4288227753150000000,57263.068000,-0.00058044392591749,1,1606821431423,60368.01,57229.83,-0.0519841551842
1717,2021-12-02,57217.37,57349.23,55895.13,56477.82,56477.82,32379968686,BTC,48.5634637356432500000,57003.722000,-0.00922574845200459,-1,1574441462737,56942.14,56477.82,-0.0081542421834
1718,2021-12-03,56509.16,57482.17,52496.59,53598.25,53598.25,39789134215,BTC,38.0750430363062500000,56780.796000,-0.05604968975778360,-1,1534652328522,58119.58,53598.25,-0.0777935766225
1719,2021-12-04,53727.88,53904.68,42874.62,49200.70,49200.70,61385677469,BTC,25.4406700221142500000,56186.204000,-0.12432774422703481,-1,1473266651053,59697.20,49200.70,-0.1758290171063
1720,2021-12-05,49201.52,49768.15,47857.50,49368.85,49368.85,37198201161,BTC,12.4222006368485000000,55497.647333,-0.11043346209300832,1,1510464852214,58730.48,49368.85,-0.1593998550667
1721,2021-12-06,49413.48,50929.52,47281.04,50582.63,50582.63,37707308001,BTC,4.5718142551242500000,54954.457333,-0.07955364396574124,1,1548172160215,56289.29,50582.63,-0.1013809198872
1722,2021-12-07,50581.83,51934.78,50175.81,50700.09,50700.09,33676814852,BTC,8.8113342863842500000,54581.844000,-0.07111804430792041,1,1581848975067,57569.07,50700.09,-0.1193171958484
1723,2021-12-08,50667.65,51171.38,48765.99,50504.80,50504.80,28479699446,BTC,12.5997368534692500000,54110.892667,-0.06664263864933810,-1,1553369275621,56280.43,50504.80,-0.1026223502557
1724,2021-12-09,50450.08,50797.16,47358.35,47672.12,47672.12,29603577251,BTC,12.1586196398505000000,53537.005333,-0.10954825165360730,-1,1523765698370,57274.68,47672.12,-0.1676580296913
1725,2021-12-10,47642.14,50015.25,47023.70,47243.30,47243.30,30966005122,BTC,8.1441213962097500000,52868.246667,-0.10639555917996905,-1,1492799693248,53569.77,47243.30,-0.1180977629734
1726,2021-12-11,47264.63,49458.21,46942.35,49362.51,49362.51,25775869261,BTC,8.8039185957390000000,52587.762667,-0.06133085918530469,1,1518575562509,54815.08,49362.51,-0.0994720795810
1727,2021-12-12,49354.86,50724.87,48725.85,50098.34,50098.34,21939223599,BTC,11.7725145717187500000,52273.313333,-0.04160771901227362,1,1540514786108,57248.46,50098.34,-0.1248962854197
1728,2021-12-13,50114.74,50205.00,45894.85,46737.48,46737.48,32166727776,BTC,11.7725145717187500000,51572.581333,-0.09375333186795791,-1,1508348058332,57806.57,46737.48,-0.1914849817244
1729,2021-12-14,46709.82,48431.40,46424.50,46612.63,46612.63,34638619079,BTC,11.7725145717187500000,50826.318667,-0.08290367623527732,-1,1473709439253,57005.43,46612.63,-0.1823124569010
1730,2021-12-15,48379.75,49473.96,46671.96,48896.72,48896.72,36541828520,BTC,12.1352762434000000000,50285.738000,-0.02762250401893276,1,1510251267773,57229.83,48896.72,-0.1456078062786
1731,2021-12-16,48900.46,49425.57,47529.88,47665.43,47665.43,27268150947,BTC,8.0462445615917500000,49648.111333,-0.03993467787126387,-1,1482983116826,56477.82,47665.43,-0.1560327576383
1732,2021-12-17,47653.73,48004.89,45618.21,46202.14,46202.14,32902725329,BTC,8.0462445615917500000,48963.066000,-0.05638793126231107,-1,1450080391497,53598.25,46202.14,-0.1379916321895
1733,2021-12-18,46219.25,47313.83,45598.44,46848.78,46848.78,26098292690,BTC,11.6403263099437500000,48513.101333,-0.03430663650167179,1,1476178684187,49200.70,46848.78,-0.0478025719146
1734,2021-12-19,46853.87,48089.66,46502.95,46707.02,46707.02,25154053861,BTC,9.0682158635797500000,48346.856000,-0.03391815178219655,-1,1451024630326,49368.85,46707.02,-0.0539171967749
1735,2021-12-20,46707.06,47401.72,45579.81,46880.28,46880.28,30961902129,BTC,10.1694105092320000000,48180.951333,-0.02699555108429640,1,1481986532455,50582.63,46880.28,-0.0731940984484
1736,2021-12-21,46886.08,49300.92,46698.77,48936.61,48936.61,27055803928,BTC,25.3678342355962500000,48071.216667,0.01800231808141599,1,1509042336383,50700.09,48936.61,-0.0347825812538
1737,2021-12-22,48937.10,49544.80,48450.94,48628.51,48628.51,24447979559,BTC,35.8718336742310000000,47933.111333,0.01450768889523861,-1,1484594356824,50504.80,48628.51,-0.0371507262676
1738,2021-12-23,48626.34,51332.34,48065.84,50784.54,50784.54,28223878108,BTC,58.0656664202597500000,47951.760667,0.05907560626756079,1,1512818234932,47672.12,50784.54,0.0652880551568
1739,2021-12-24,50806.05,51814.03,50514.50,50822.20,50822.20,24367912228,BTC,79.2965049133510000000,48161.766000,0.05523954416455576,1,1537186147160,47243.30,50822.20,0.0757546572742
1740,2021-12-25,50854.92,51176.60,50236.71,50429.86,50429.86,19030650914,BTC,86.9750568106800000000,48374.203333,0.04249489449674654,-1,1518155496246,49362.51,50429.86,0.0216226849080
1741,2021-12-26,50428.69,51196.38,49623.11,50809.52,50809.52,20964372926,BTC,97.8083617961672500000,48470.670667,0.04825287747859336,1,1539119869172,50098.34,50809.52,0.0141956799367
1742,2021-12-27,50802.61,51956.33,50499.47,50640.42,50640.42,24324345758,BTC,96.8247165621227500000,48506.809333,0.04398579697033317,-1,1514795523414,46737.48,50640.42,0.0835077115839
1743,2021-12-28,50679.86,50679.86,47414.21,47588.86,47588.86,33430376883,BTC,79.3285152140882500000,48563.568000,-0.02007076580534610,-1,1481365146531,46612.63,47588.86,0.0209434653226
1744,2021-12-29,47623.87,48119.74,46201.50,46444.71,46444.71,30049226299,BTC,57.7641307688645000000,48552.373333,-0.04341009899854817,-1,1451315920232,48896.72,46444.71,-0.0501467174076
1745,2021-12-30,46490.61,47879.96,46060.31,47178.13,47178.13,26686491018,BTC,38.1140071773960000000,48437.800667,-0.02600594266572875,1,1478002411250,47665.43,47178.13,-0.0102233421580
1746,2021-12-31,47169.37,48472.53,45819.95,46306.45,46306.45,36974172400,BTC,14.6620931329895000000,48347.202000,-0.04221034342380351,-1,1441028238850,46202.14,46306.45,0.0022576876309
1747,2022-01-01,46311.75,47827.31,46288.48,47686.81,47686.81,24582667004,BTC,14.8002144278767500000,48446.180000,-0.01567450725733174,1,1465610905854,46848.78,47686.81,0.0178879791534
1748,2022-01-02,47680.93,47881.41,46856.94,47345.22,47345.22,27951569547,BTC,19.2384398357992500000,48479.276000,-0.02339259356926040,-1,1437659336307,46707.02,47345.22,0.0136638989171
1749,2022-01-03,47343.54,47510.73,45835.96,46458.12,46458.12,33071628362,BTC,14.7968495130012500000,48462.682667,-0.04136301493612898,-1,1404587707945,46880.28,46458.12,-0.0090050656694
1750,2022-01-04,46458.85,47406.55,45752.46,45897.57,45897.57,42494677905,BTC,14.2324087914522500000,48397.168667,-0.05164762187223509,-1,1362093030040,48936.61,45897.57,-0.0621015636351
1751,2022-01-05,45899.36,46929.05,42798.22,43569.00,43569.00,36851084859,BTC,6.5904888445995000000,48039.328000,-0.09305558978676804,-1,1325241945181,48628.51,43569.00,-0.1040441091039
1752,2022-01-06,43565.51,43748.72,42645.54,43160.93,43160.93,30208048289,BTC,0.8396722582075000000,47674.822667,-0.09468084860071159,-1,1295033896892,50784.54,43160.93,-0.1501167481285
1753,2022-01-07,43153.57,43153.57,41077.45,41557.90,41557.90,84196607520,BTC,0E-19,47059.713333,-0.11691132272881752,-1,1210837289372,50822.20,41557.90,-0.1822884487488
1754,2022-01-08,41561.46,42228.94,40672.28,41733.94,41733.94,28066355845,BTC,0.4757004719172500000,46453.829333,-0.10160388068690544,1,1238903645217,50429.86,41733.94,-0.1724359337900
1755,2022-01-09,41734.73,42663.95,41338.16,41911.60,41911.60,21294384372,BTC,1.4314790274567500000,45885.945333,-0.08661356552987375,1,1260198029589,50809.52,41911.60,-0.1751230871695
1756,2022-01-10,41910.23,42199.48,39796.57,41821.26,41821.26,32104232331,BTC,2.1563879734320000000,45286.728000,-0.07652281701605821,-1,1228093797258,50640.42,41821.26,-0.1741525840425
1757,2022-01-11,41819.51,43001.16,41407.75,42735.86,42735.86,26327648900,BTC,6.9613206612997500000,44759.757333,-0.04521689690904205,1,1254421446158,47588.86,42735.86,-0.1019776477100
1758,2022-01-12,42742.18,44135.37,42528.99,43949.10,43949.10,33499938689,BTC,16.2393936988645000000,44517.106667,-0.01275928984443763,1,1287921384847,46444.71,43949.10,-0.0537329224362
1759,2022-01-13,43946.74,44278.42,42447.04,42591.57,42591.57,47691135082,BTC,19.4999847751192500000,44260.230667,-0.03770112902380640,-1,1240230249765,47178.13,42591.57,-0.0972179270353
1760,2022-01-14,42598.87,43346.69,41982.62,43099.70,43099.70,23577403399,BTC,25.0641223317032500000,43988.335333,-0.02020161313841187,1,1263807653164,46306.45,43099.70,-0.0692506119558
1761,2022-01-15,43101.90,43724.67,42669.04,43177.40,43177.40,18371348298,BTC,26.8651766790505000000,43779.732000,-0.01375823862969285,1,1282179001462,47686.81,43177.40,-0.0945630458401
1762,2022-01-16,43172.04,43436.81,42691.02,43113.88,43113.88,17902097845,BTC,23.8329081148627500000,43474.870000,-0.00830341758353734,-1,1264276903617,47345.22,43113.88,-0.0893720633255
1763,2022-01-17,43118.12,43179.39,41680.32,42250.55,42250.55,21690904261,BTC,23.1503083954397500000,43135.225333,-0.02050934766586675,-1,1242585999356,46458.12,42250.55,-0.0905669450249
1764,2022-01-18,42250.07,42534.40,41392.21,42375.63,42375.63,22417209227,BTC,21.5720463534500000000,42863.059333,-0.01137178121638955,1,1265003208583,45897.57,42375.63,-0.0767347813839
1765,2022-01-19,42374.04,42478.30,41242.91,41744.33,41744.33,23091543258,BTC,16.9151852800952500000,42586.176667,-0.01976807341928740,-1,1241911665325,43569.00,41744.33,-0.0418800064266
1766,2022-01-20,41744.03,43413.02,40672.82,40680.42,40680.42,20382033940,BTC,10.1936803348010000000,42393.604667,-0.04041139413496432,-1,1221529631385,43160.93,40680.42,-0.0574711898006
1767,2022-01-21,40699.61,41060.53,35791.43,36457.32,36457.32,43011992031,BTC,6.6599104224297500000,41946.697333,-0.13086554322553154,-1,1178517639354,41557.90,36457.32,-0.1227343056314
1768,2022-01-22,36471.59,36688.81,34349.25,35030.25,35030.25,39714385405,BTC,1.9491259618602500000,41511.520667,-0.15613185358811370,-1,1138803253949,41733.94,35030.25,-0.1606292144954
1769,2022-01-23,35047.36,36433.31,34784.97,36276.80,36276.80,26017975951,BTC,3.4941444244492500000,41147.711333,-0.11837623953324432,1,1164821229900,41911.60,36276.80,-0.1344448792220
1770,2022-01-24,36275.73,37247.52,33184.06,36654.33,36654.33,41856658597,BTC,8.0465250564815000000,40797.226667,-0.10154848761695608,1,1206677888497,41821.26,36654.33,-0.1235479275373
1771,2022-01-25,36654.80,37444.57,35779.43,36954.00,36954.00,26428189594,BTC,13.4388962702590000000,40472.742667,-0.08694104810122133,1,1233106078091,42735.86,36954.00,-0.1352929366579
1772,2022-01-26,36950.52,38825.41,36374.91,36852.12,36852.12,31324598034,BTC,18.5456925500485000000,40080.493333,-0.08054724541880678,-1,1201781480057,43949.10,36852.12,-0.1614818050882
1773,2022-01-27,36841.88,37148.32,35629.28,37138.23,37138.23,25041426629,BTC,21.5200064208312500000,39626.435333,-0.06279155094548408,1,1226822906686,42591.57,37138.23,-0.1280380131561
1774,2022-01-28,37128.45,37952.88,36211.11,37784.33,37784.33,22238830523,BTC,25.4186792246630000000,39305.952667,-0.03871227037520719,1,1249061737209,43099.70,37784.33,-0.1233273085428
1775,2022-01-29,37780.71,38576.26,37406.47,38138.18,38138.18,17194183075,BTC,29.5631705947337500000,38975.184667,-0.02147532267393426,1,1266255920284,43177.40,38138.18,-0.1167096675576
1776,2022-01-30,38151.92,38266.34,37437.71,37917.60,37917.60,14643548444,BTC,33.3859950422660000000,38624.531333,-0.01830265141355935,-1,1251612371840,43113.88,37917.60,-0.1205245271360
1777,2022-01-31,37920.28,38647.26,36733.57,38483.13,38483.13,20734730465,BTC,38.6694134368717500000,38315.814667,0.00436674345708490,1,1272347102305,42250.55,38483.13,-0.0891685433681
1778,2022-02-01,38481.77,39115.13,38113.66,38743.27,38743.27,20288500328,BTC,42.8556231514505000000,38081.996000,0.01736447847954188,1,1292635602633,42375.63,38743.27,-0.0857181356360
1779,2022-02-02,38743.71,38834.62,36832.73,36952.98,36952.98,19155189416,BTC,40.4780809808235000000,37720.486000,-0.02034719276946750,-1,1273480413217,41744.33,36952.98,-0.1147784621289
1780,2022-02-03,36944.80,37154.60,36375.54,37154.60,37154.60,18591534769,BTC,40.9479561978715000000,37414.504000,-0.00694661086513401,1,1292071947986,40680.42,37154.60,-0.0866711798944
1781,2022-02-04,37149.27,41527.79,37093.63,41500.88,41500.88,29412210792,BTC,54.1960795080337500000,37469.201333,0.10759980259972092,1,1321484158778,36457.32,41500.88,0.1383414908172
1782,2022-02-05,41501.48,41847.16,41038.10,41441.16,41441.16,19652846215,BTC,66.3280814832432500000,37801.457333,0.09628471820377688,-1,1301831312563,35030.25,41441.16,0.1830106836234
1783,2022-02-06,41441.12,42500.79,41244.91,42412.43,42412.43,16142097334,BTC,84.1687610700220000000,38293.602667,0.10755914946987874,1,1317973409897,36276.80,42412.43,0.1691337163146
1784,2022-02-07,42406.78,44401.86,41748.16,43840.29,43840.29,28641855926,BTC,99.7692651256522500000,38797.835333,0.12996742276265797,1,1346615265823,36654.33,43840.29,0.1960466880721
1785,2022-02-08,43854.65,45293.87,42807.84,44118.45,44118.45,33079398868,BTC,99.7692651256522500000,39295.443333,0.12273704679009633,1,1379694664691,36954.00,44118.45,0.1938748173405
1786,2022-02-09,44096.70,44727.80,43232.97,44338.80,44338.80,23245887300,BTC,100.0000000000000000000,39787.763333,0.11438282239970415,1,1402940551991,36852.12,44338.80,0.2031546624726
1787,2022-02-10,44347.80,45661.17,43402.81,43565.11,43565.11,32142048537,BTC,97.3811641767602500000,40235.296000,0.08275853121597515,-1,1370798503454,37138.23,43565.11,0.1730529430186
1788,2022-02-11,43571.13,43810.83,42114.54,42407.94,42407.94,26954925781,BTC,90.8454646877395000000,40586.610000,0.04487514478297153,-1,1343843577673,37784.33,42407.94,0.1223684527422
1789,2022-02-12,42412.30,42992.55,41852.57,42244.47,42244.47,18152390304,BTC,83.7564413971637500000,40883.952667,0.03327753908927105,-1,1325691187369,38138.18,42244.47,0.1076687455982
1790,2022-02-13,42236.57,42693.05,41950.94,42197.52,42197.52,14741589015,BTC,76.5084987178132500000,41154.575333,0.02534213167214265,-1,1310949598354,37917.60,42197.52,0.1128742325464
1791,2022-02-14,42157.40,42775.78,41681.96,42586.92,42586.92,20827783012,BTC,73.1974581021470000000,41465.863333,0.02703565238705216,1,1331777381366,38483.13,42586.92,0.1066386751805
1792,2022-02-15,42586.46,44667.22,42491.04,44575.20,44575.20,22721659051,BTC,79.7331575911677500000,41872.001333,0.06455862105806644,1,1354499040417,38743.27,44575.20,0.1505275625935
1793,2022-02-16,44578.28,44578.28,43456.69,43961.86,43961.86,19792547657,BTC,84.8104966217772500000,42219.907333,0.04125903577335547,-1,1334706492760,36952.98,43961.86,0.1896702241605
1794,2022-02-17,43937.07,44132.97,40249.37,40538.01,40538.01,26246662813,BTC,78.4571469528000000000,42458.909333,-0.04524137249816341,-1,1308459829947,37154.60,40538.01,0.0910630177690
1795,2022-02-18,40552.13,40929.15,39637.62,40030.98,40030.98,23310007704,BTC,59.3870233917060000000,42650.668000,-0.06142196881887055,-1,1285149822243,41500.88,40030.98,-0.0354185260650
1796,2022-02-19,40026.02,40418.88,39713.06,40122.16,40122.16,13736557863,BTC,34.8886496333932500000,42558.753333,-0.05725246023855376,1,1298886380106,41441.16,40122.16,-0.0318282596337
1797,2022-02-20,40118.10,40119.89,38112.81,38431.38,38431.38,18340576452,BTC,11.9003338933595000000,42358.101333,-0.09270295904270861,-1,1280545803654,42412.43,38431.38,-0.0938651711303
1798,2022-02-21,38423.21,39394.44,36950.48,37075.28,37075.28,29280402798,BTC,0.5016262416872500000,42002.291333,-0.11730339409195488,-1,1251265400856,43840.29,37075.28,-0.1543103387318
1799,2022-02-22,37068.77,38359.86,36488.93,38286.03,38286.03,25493150450,BTC,4.5375026243687500000,41632.007333,-0.08037030994534294,1,1276758551306,44118.45,38286.03,-0.1321991139761
1800,2022-02-23,38285.28,39122.39,37201.82,37296.57,37296.57,21849073843,BTC,4.7735175841877500000,41177.215333,-0.09424253926879791,-1,1254909477463,44338.80,37296.57,-0.1588277084630
1801,2022-02-24,37278.57,38968.84,34459.22,38332.61,38332.61,46383802093,BTC,8.9646622897312500000,40776.802667,-0.05994076305982777,1,1301293279556,43565.11,38332.61,-0.1201075815027
1802,2022-02-25,38333.75,39630.32,38111.34,39214.22,39214.22,26545599159,BTC,16.0945383417425000000,40486.743333,-0.03143061724015697,1,1327838878715,42407.94,39214.22,-0.0753094821394
1803,2022-02-26,39213.08,40005.35,38702.54,39105.15,39105.15,17467554129,BTC,18.8249674663197500000,40266.557333,-0.02884297565831837,-1,1310371324586,42244.47,39105.15,-0.0743131586217
1804,2022-02-27,39098.70,39778.94,37268.98,37709.79,37709.79,23450127612,BTC,20.2023821587430000000,39964.245333,-0.05641180796021213,-1,1286921196974,42197.52,37709.79,-0.1063505627819
1805,2022-02-28,37706.00,43760.46,37518.21,43193.23,43193.23,35690014104,BTC,36.4046216492975000000,40030.626000,0.07900461012026142,1,1322611211078,42586.92,43193.23,0.0142370004687
1806,2022-03-01,43194.50,44793.60,42952.59,44354.64,44354.64,32479047645,BTC,53.5395377550692500000,40148.474000,0.10476527700654326,1,1355090258723,44575.20,44354.64,-0.0049480428579
1807,2022-03-02,44357.62,45077.58,43432.85,43924.12,43924.12,29183112630,BTC,70.2946681982237500000,40105.068667,0.09522615120573183,-1,1325907146093,43961.86,43924.12,-0.0008584714114
1808,2022-03-03,43925.20,44021.58,41914.75,42451.79,42451.79,24967782593,BTC,86.6445254285250000000,40004.397333,0.06117809116402119,-1,1300939363500,40538.01,42451.79,0.0472095201516
1809,2022-03-04,42458.14,42479.61,38805.85,39137.61,39137.61,28516271427,BTC,73.3339410939532500000,39911.037333,-0.01937878303054028,-1,1272423092073,40030.98,39137.61,-0.0223169655102
1810,2022-03-05,39148.45,39566.34,38777.04,39400.59,39400.59,16975917450,BTC,57.0551188566027500000,39869.011333,-0.01174900799740381,1,1289399009523,40122.16,39400.59,-0.0179843258688
1811,2022-03-06,39404.20,39640.18,38211.65,38419.98,38419.98,19745229902,BTC,38.1518773628450000000,39755.532667,-0.03359413337979512,-1,1269653779621,38431.38,38419.98,-0.0002966325956
1812,2022-03-07,38429.30,39430.23,37260.20,38062.04,38062.04,28546143503,BTC,23.0758610647087500000,39730.910000,-0.04200432358584286,-1,1241107636118,37075.28,38062.04,0.0266150383760
1813,2022-03-08,38059.90,39304.44,37957.39,38737.27,38737.27,25776583476,BTC,21.0960851176520000000,39841.709333,-0.02772068145392591,1,1266884219594,38286.03,38737.27,0.0117860222123
1814,2022-03-09,38742.82,42465.67,38706.09,41982.93,41982.93,32284121034,BTC,29.7094121721715000000,40088.169333,0.04726483395290043,1,1299168340628,37296.57,41982.93,0.1256512328077
1815,2022-03-10,41974.07,42004.73,38832.94,39437.46,39437.46,31078064711,BTC,31.5912515763255000000,40230.895333,-0.01972204014930716,-1,1268090275917,38332.61,39437.46,0.0288227177852
1816,2022-03-11,39439.97,40081.68,38347.43,38794.97,38794.97,26364890465,BTC,32.2851406671440000000,40261.719333,-0.03643037002142623,-1,1241725385452,39214.22,38794.97,-0.0106912747468
1817,2022-03-12,38794.46,39308.60,38772.54,38904.01,38904.01,14616450657,BTC,31.6751451882297500000,40241.038667,-0.03322550091373366,1,1256341836109,39105.15,38904.01,-0.0051435680467
1818,2022-03-13,38884.73,39209.35,37728.14,37849.66,37849.66,17300745310,BTC,15.6020828160152500000,40157.339333,-0.05746594200038606,-1,1239041090799,37709.79,37849.66,0.0037091163860
1819,2022-03-14,37846.32,39742.50,37680.73,39666.75,39666.75,24322159070,BTC,16.0855062448515000000,40287.803333,-0.01541541810722878,1,1263363249869,43193.23,39666.75,-0.0816442761979
1820,2022-03-15,39664.25,39794.63,38310.21,39338.79,39338.79,23934000868,BTC,17.7257586770187500000,40030.840667,-0.01728793738699827,-1,1239429249001,44354.64,39338.79,-0.1130851248032
1821,2022-03-16,39335.57,41465.45,39022.35,41143.93,41143.93,39616916192,BTC,26.7906020522912500000,39816.793333,0.03333107857030954,1,1279046165193,43924.12,41143.93,-0.0632952919717
1822,2022-03-17,41140.84,41287.54,40662.87,40951.38,40951.38,22009601093,BTC,43.1137393708162500000,39618.610667,0.03363998157840803,-1,1257036564100,42451.79,40951.38,-0.0353438571142
1823,2022-03-18,40944.84,42195.75,40302.40,41801.16,41801.16,34421564942,BTC,60.0308499124517500000,39575.235333,0.05624539306640337,1,1291458129042,39137.61,41801.16,0.0680560207943
1824,2022-03-19,41794.65,42316.55,41602.67,42190.65,42190.65,19664853187,BTC,79.3078115633715000000,39778.771333,0.06063230678518051,1,1311122982229,39400.59,42190.65,0.0708126451914
1825,2022-03-20,42191.41,42241.16,41004.76,41247.82,41247.82,20127946682,BTC,85.3201299626110000000,39901.920000,0.03373020646625526,-1,1290995035547,38419.98,41247.82,0.0736033699133
1826,2022-03-21,41246.13,41454.41,40668.04,41078.00,41078.00,24615543271,BTC,87.0629455377490000000,40079.121333,0.02492266880555467,-1,1266379492276,38062.04,41078.00,0.0792380019568
